INPUT:diff1	INPUT:diff2	INPUT:query1	INPUT:query2
ока	окна	ока	окна
антена	антенну	антена куликова	антенну куликова
campions	champion	campions	champion
летная	летний	goodyear efficientgrip suv летная 215 60 r17	goodyear efficientgrip suv летний 215 60 r17
клонки	колонка	блютуз клонки	блютуз колонка
mersedes	mercedes	mersedes gl 164	mercedes gl 164
фильт	фильтр	фильт масляный лансер 10	фильтр масляный лансер 10
sex	dex	club sex	club dex
матиз	машин	бензобак део матиз б у	бензобак део машин б у
voyage	voyager	guerlain meteorites voyage	guerlain meteorites voyager
аккумуляторный	аккумуляторы	аккумуляторный dc44	аккумуляторы dc44
ada	lada	бензобур ada ground drill-8	бензобур lada ground drill-8
lexis	lexus	lexis is250	lexus is250
lsd	led	lsd редуктор	led редуктор
аутлендор	аутлендер	бампер передний аутлендор хл	бампер передний аутлендер хл
ass	asus	ass	asus
sister	duster	five nights sister location	five nights duster location
loong	long	loong board	long board
rolf	golf	rolf benz	golf benz
ringer	range	ralf ringer обувь 40 р	ralf range обувь 40 р
scoda	skoda	scoda octavia a7	skoda octavia a7
apll	apple	apll ноут	apple ноут
squier	super	squier stratocaster standart	super stratocaster standart
mims	moms	mims	moms
slr	xlr	mercedes-benz slr mclaren	mercedes-benz xlr mclaren
барс	бара	ак барс одежда	ак бара одежда
boy	baby	game boy e reader	game baby e reader
тракер	трактор	бампер шевроле тракер	бампер шевроле трактор
hts	htc	hts-350-36	htc-350-36
akai	kia	akai 61 advance	kia 61 advance
батарейная	батарейках	батарейная ручка canon	батарейках ручка canon
originals	original	adidas originals x opening ceremon	adidas original x opening ceremon
фарсунка	форсунка	бампер фарсунка	бампер форсунка
док	дом	sata док станция hdd	sata дом станция hdd
elie	elite	l eau couture elie saab	l eau couture elite saab
батскетбольный	баскетбольный	батскетбольный мяч	баскетбольный мяч
кампьютер	компьютеры	бортовой кампьютер приора	бортовой компьютеры приора
akzent	accent	борона akzent	борона accent
александрова	александров	александрова 21	александров 21
ваты	воды	аппарат для сахарной ваты аренда	аппарат для сахарной воды аренда
кремень	времен	2 кремень	2 времен
nex	nexia	metabones canon ef to e-mount nex iii smart adapter	metabones canon ef to e-mount nexia iii smart adapter
msmg	msgm	msmg	msgm
тестер	мастер	tom ford тестер	tom ford мастер
ebs	abs	блок управления ebs	блок управления abs
балетные	бальные	балетные туфли	бальные туфли
nivo	niva	nikon nivo	nikon niva
недвижемости	недвижимости	аренда недвижемости	аренда недвижимости
les	led	gibson les paul burst	gibson led paul burst
делл	дело	батарея для ноутбука делл	батарея для ноутбука дело
некси	нексия	бампер на некси	бампер на нексия
rsn	rsd	rsn	rsd
texier	texet	texier сумка	texet сумка
ted	red	ted baker оригинал	red baker оригинал
аудия	ауди	аудия а4	ауди а4
вакумные	вакуумные	банки вакумные	банки вакуумные
водител	водителя	аренда машина без водител	аренда машина без водителя
ears	ear	ultimate ears boom 2	ultimate ear boom 2
аккомулятор	аккумуляторы	аккомулятор для zte	аккумуляторы для zte
салярис	солярис	акпп салярис	акпп солярис
ymaxa	ymaha	ymaxa jog	ymaha jog
баннер	бампер	баннер фото зона	бампер фото зона
forza	corsa	forza farint	corsa farint
jtc	htc	jtc 1184	htc 1184
hair	air	hair журнал	air журнал
плата	платья	iphone 7 сгоревшая плата	iphone 7 сгоревшая платья
аккомулятор	аккумуляторы	аккомулятор на самсунг с 5 мини	аккумуляторы на самсунг с 5 мини
sbr	cbr	sbr 600rr	cbr 600rr
магнитолла	магнитол	freelander 2 магнитолла	freelander 2 магнитол
irbid	irbis	irbid gs200	irbis gs200
samsug	samsung	samsug galaxy s9	samsung galaxy s9
аксесуары	аксессуара	аксесуары dolce gabbana оригинал	аксессуара dolce gabbana оригинал
bricks	tracks	lego bricks	lego tracks
аллюминиевый	алюминиевый	аллюминиевый диск 22 5	алюминиевый диск 22 5
басаножки	босоножки	басаножки детские 23 размер	босоножки детские 23 размер
тени	одни	yves saint laurent тени	yves saint laurent одни
vls	cls	vls 300	cls 300
барс	бара	барс костюм	бара костюм
srt	art	sony srt-dg820	sony art-dg820
понель	опель	bmw 3 f понель передняя	bmw 3 f опель передняя
шипы	шины	65 15 шипы	65 15 шины
apv	apc	chevrolet lumina apv	chevrolet lumina apc
iphene	iphone	iphene	iphone
haggies	huggies	haggies	huggies
ymaha	yamaha	ymaha yz85	yamaha yz85
стеклоподьемников	стеклоподъемников	mitsubishi carisma блок кнопок стеклоподьемников	mitsubishi carisma блок кнопок стеклоподъемников
вагон	район	brio вагон	brio район
leeco	lego	leeco le pro3	lego le pro3
бра	пара	бра nike	пара nike
ранец	баней	erich krause ранец	erich krause баней
xpro	pro	godox xpro	godox pro
-комнатные	комнатные	1-комнатные по ул почтовая	1 комнатные по ул почтовая
citizen	citroen	citizen skyhawk	citroen skyhawk
слюдянка	славянка	3 комнатная квартира слюдянка	3 комнатная квартира славянка
usm	usb	canon 70-200 2 8 l is usm	canon 70-200 2 8 l is usb
cover	rover	samsung clear view standing cover для galaxy s8	samsung clear view standing rover для galaxy s8
omni	one	zyxel omni 56k usb plus ee	zyxel one 56k usb plus ee
обьмен	обмен	iphone 6 обьмен	iphone 6 обмен
bike	nike	tramp bike 2 alu	tramp nike 2 alu
рейсталинг	рестайлинг	opel astra g рейсталинг	opel astra g рестайлинг
корова	коробка	большая мягкая игрушка корова	большая мягкая игрушка коробка
rsim	sim	iphone rsim	iphone sim
базы	без	аренда базы отдыха на парном	аренда без отдыха на парном
akai	kia	akai dt	kia dt
gauss	guess	gauss светодиодные лампочки	guess светодиодные лампочки
расрочка	рассрочку	авто расрочка по чиченской республике	авто рассрочку по чиченской республике
центов	центр	50 центов	50 центр
аифон	айфон	аифон 5s не рабочий	айфон 5s не рабочий
guliver	gulliver	guliver 122 комплект	gulliver 122 комплект
ufp	газ	ufp 21	газ 21
аире	мире	аире 71 с 2 в 2	мире 71 с 2 в 2
prolodgy	prology	prolodgy imap	prology imap
bens	benz	mercedes-bens ml 350	mercedes-benz ml 350
через	берег	samsonite через плечо	samsonite берег плечо
michlen	michelin	205 60 15 michlen	205 60 15 michelin
cedtybhs	сувениры	cedtybhs	сувениры
челси	чулки	ботинки челси мужские	ботинки чулки мужские
басейны	бассейна	басейны детский	бассейна детский
rasing	racing	bs rasing	bs racing
ema	ems	blaupunkt ema 255	blaupunkt ems 255
nar	bar	nar пленка	bar пленка
антон	айфон	антон шоп	айфон шоп
nbcrb	тиски	nbcrb	тиски
cic	ice	cic e71	ice e71
jole	joie	jole коляска	joie коляска
forza	corsa	forza 5 xbox one	corsa 5 xbox one
домик	домом	бетонный домик	бетонный домом
sub	usb	genelec sub	genelec usb
solo	polo	microlab solo 4c	microlab polo 4c
уазик	уаза	уазик 69 двигатель	уаза 69 двигатель
арнда	аренду	арнда помещения для свадьбы	аренду помещения для свадьбы
акумулятор	аккумулятор	акумулятор бу шевроле кобольт	аккумулятор бу шевроле кобольт
гжель	опель	блинница гжель	блинница опель
стелла	стеллажи	адидас стелла	адидас стеллажи
аккамулятор	аккумулятора	аккамулятор 18 вольт	аккумулятора 18 вольт
loves	love	grace loves	grace love
барни	барный	барни стинсон	барный стинсон
nex	max	nex боди	max боди
виско	виска	mercedes w124 виско муфта	mercedes w124 виска муфта
emc	ems	emc пивторак	ems пивторак
cthnbabrfn	сертификат	cthnbabrfn	сертификат
akai	kia	akai s6000	kia s6000
soni	sony	soni ericsson t650i	sony ericsson t650i
ciaomi	xiaomi	ciaomi	xiaomi
bayer	bauer	bayer x90	bauer x90
gsx	gtx	suzuki gsx r поворотники	suzuki gtx r поворотники
wolf	golf	r wolf	r golf
axon	canon	баллы axon	баллы canon
pel	opel	bosh pst 800 pel	bosh pst 800 opel
мерсидес	мерседес	автомабиль мерсидес	автомабиль мерседес
viktorias	victorias	viktorias secret	victorias secret
щаток	щиток	щаток для приоры	щиток для приоры
бензанасос	бензонасос	бензанасос krauf	бензонасос krauf
merseders	mercedes	merseders w 221	mercedes w 221
fitch	watch	fitch	watch
ecx	kicx	hertz ecx 130	hertz kicx 130
guliver	gulliver	guliver 116	gulliver 116
volswagen	volkswagen	volswagen golf 5 супорт передний	volkswagen golf 5 супорт передний
арома	аромат	арома лампы	аромат лампы
брендированые	брендированные	брендированые пакеты	брендированные пакеты
приус	приму	бампер тойота приус 30	бампер тойота приму 30
vjht	море	vjht	море
тди	ауди	ауди 2 5 тди 180 л с	ауди 2 5 ауди 180 л с
yamaxa	yamaha	yamaxa rx1	yamaha rx1
опел	опель	бампер передний опел зафира	бампер передний опель зафира
bay	baby	emerald bay	emerald baby
сервес	сервис	авто сервес	авто сервис
кулиса	колеса	nissan primera p12 кулиса переключения передач	nissan primera p12 колеса переключения передач
амартизатор	амортизатора	амартизатор на нексиа	амортизатора на нексиа
кардан	карта	audi а4 б6 кардан	audi а4 б6 карта
uns	unc	5 рублей 1998 года спмд uns	5 рублей 1998 года спмд unc
gxt	gtx	gxt 1060 6g	gtx 1060 6g
engel	angel	автохолодильник engel	автохолодильник angel
нисан	диван	амортизаторы задние нисан максима	амортизаторы задние диван максима
monde	mondeo	monde	mondeo
vest	vesta	tasmanian tiger ammunition vest	tasmanian tiger ammunition vesta
hdr	hdd	lexand d6 hdr	lexand d6 hdd
focal	focus	165 focal	165 focus
после	шоссе	автовышка после дтп	автовышка шоссе дтп
cnfyjr	станок	njxbkmysq cnfyjr	njxbkmysq станок
tevtonia	teutonia	tevtonia	teutonia
сузуки	сумки	бензобак сузуки	бензобак сумки
бабка	маска	бабка для забивания	маска для забивания
футов	кузов	бильярд 10 футов	бильярд 10 кузов
huyndai	hyundai	huyndai hd120 редуктор	hyundai hd120 редуктор
bmx	bmw	fatboy mini bmx	fatboy mini bmw
стеклоподъёмника	стеклоподъемники	блок кнопок стеклоподъёмника мерседес 203	блок кнопок стеклоподъемники мерседес 203
агента	аренда	аренда комната без агента	аренда комната без аренда
ssb	ssd	ssb приемник	ssd приемник
плата	платья	samsung материнская плата с процессором	samsung материнская платья с процессором
амартизаторы	амортизаторы	амартизаторы ниссан	амортизаторы ниссан
кусок	кузов	кожа кусок	кожа кузов
honey	honor	honey bronze	honor bronze
суточно	срочно	1 комнатная квартира по суточно в орле	1 комнатная квартира по срочно в орле
салярис	солярис	бампер в цвет на салярис	бампер в цвет на солярис
альфард	альфа	альфард alphard	альфа alphard
xari	zara	mima xari махачкала	mima zara махачкала
crysler	chrysler	crysler 300	chrysler 300
greco	graco	greco jazz bass	graco jazz bass
audio	audi	crest audio vs 900	crest audi vs 900
cry	core	far cry 3 на ps4	far core 3 на ps4
ahb	фри	ahb	фри
shark	smart	xiaomi black shark	xiaomi black smart
avd	amd	avd models	amd models
open	opel	push to open	push to opel
городок	город	32 военный городок	32 военный город
битовой	бытовой	битовой техника	бытовой техника
крокид	сроки	80-86 крокид	80-86 сроки
rub	run	gosha rub	gosha run
борка	уборка	борка	уборка
aqua	asus	lego aqua	lego asus
метан	металл	баллон метан 100	баллон металл 100
aqua	asus	aqua lung legend acd	asus lung legend acd
focal	focus	jm lab focal	jm lab focus
ibanes	ibanez	ibanes	ibanez
kit	kia	canon 70d kit	canon 70d kia
аллюминий	алюминий	бидон аллюминий	бидон алюминий
russo	rosso	anna dello russo	anna dello rosso
краги	книги	true краги	true книги
подьемники	подъемник	автомобильные ножничные подьемники	автомобильные ножничные подъемник
yota	toyota	yota номер	toyota номер
bmx	bmw	bmx freedom	bmw freedom
gti	gtx	бампер gti vw golf 7	бампер gtx vw golf 7
yo-yo	yoyo	yo-yo коляска	yoyo коляска
hynday	hyndai	hynday	hyndai
ресталинг	рестайлинга	блок климата ford фокус 2 ресталинг	блок климата ford фокус 2 рестайлинга
bust	boost	bust	boost
wee	eee	wee trike 360	eee trike 360
алаптер	адаптер	алаптер	адаптер
маслянный	масляный	маслянный насос кио соренто	масляный насос кио соренто
utnw	гетц	eylfq utnw	eylfq гетц
аварийка	аварийная	focus аварийка	focus аварийная
zdac	dac	parasound zdac	parasound dac
cумка	сумки	cумка chanel оригинал	сумки chanel оригинал
macbooc	macbook	macbooc air	macbook air
gti	gtx	golf gti колеса	golf gtx колеса
gll	glk	gll	glk
база	без	автокресло maxi-cosi pearl база	автокресло maxi-cosi pearl без
апликатор	аппликатор	апликатор	аппликатор
rocker	rover	lol rocker	lol rover
fist	fiat	fist 500	fiat 500
carat	carlo	carat	carlo
elise	elite	rance elise	rance elite
слон	салон	hasbro слон	hasbro салон
абисинская	абиссинская	абисинская	абиссинская
адель	газель	3-к квартира адель кутуя	3-к квартира газель кутуя
бобер	ковер	бобер 31	ковер 31
ьштш	mini	mac ьштш	mac mini
bmv	bmw	автомобиль без пробега bmv	автомобиль без пробега bmw
решотка	решетки	решотка м f15	решетки м f15
pkfnjecn	златоуст	pkfnjecn 2107 2005	златоуст 2107 2005
reyu	кунг	reyu	кунг
tough	touch	olympus tough tg-860	olympus touch tg-860
artik	arctic	artik	arctic
brtf	икеа	cntkkf brtf	cntkkf икеа
березовка	березовая	богородский район д березовка	богородский район д березовая
арболет	арбалета	арболет	арбалета
стеклоподемников	стеклоподъемников	блок стеклоподемников форд фокус 2	блок стеклоподъемников форд фокус 2
капо	капа	3 капо им горбунова	3 капа им горбунова
usn	usm	usn	usm
хутор	мотор	адлер хутор россия	адлер мотор россия
амарок	марок	амарок молдинг	марок молдинг
sex	dex	sex игрушка	dex игрушка
cover	rover	samsung note 8 cover	samsung note 8 rover
каленвала	коленвала	focus 1 датчик каленвала	focus 1 датчик коленвала
банер	бампер	банер рекламный	бампер рекламный
gxt	gtx	бесперебойник gxt 2u	бесперебойник gtx 2u
focuc	focus	ford focuc 2 фара	ford focus 2 фара
leeco	lego	leeco cool1 4 32gb	lego cool1 4 32gb
iroar	inoar	iroar creative labs	inoar creative labs
jps	gps	jps трекер	gps трекер
перед	передня	бампер перед теана	бампер передня теана
беж	без	42 балетки беж	42 балетки без
roger	rover	roger dubuis knights	rover dubuis knights
glm	glc	glm 100	glc 100
бомбер	бампер	бомбер женский бренд	бампер женский бренд
nex	nexia	sony nex vg 10	sony nexia vg 10
автомагнитолла	автомагнитола	jvc автомагнитолла	jvc автомагнитола
тестер	мастер	dior fahrenheit тестер	dior fahrenheit мастер
взломанная	сломанная	playstation 4 взломанная	playstation 4 сломанная
scoda	skoda	scoda octavia а5 дверь	skoda octavia а5 дверь
gds	gtc	hyundai kia gds vci	hyundai kia gtc vci
kixc	kicx	kixc qs1 600	kicx qs1 600
isalnd	island	stone isalnd	stone island
соул	стул	дверь киа соул	дверь киа стул
melisa	melissa	melisa	melissa
банная	баня	банная печь бу	баня печь бу
кандиционер	кондиционеры	астрахань кандиционер	астрахань кондиционеры
белова	беговая	белова 17а	беговая 17а
плата	платье	macbook 12 плата	macbook 12 платье
viana	viano	viana мерседес бенс 7 местный 2010 года цена	viano мерседес бенс 7 местный 2010 года цена
eci	eco	eci	eco
бартер	бампер	бартер на шивролет ланос	бампер на шивролет ланос
ампер	бампер	аккумулятор 140 ампер	аккумулятор 140 бампер
спарк	сварка	chevrolet спарк	chevrolet сварка
cумка	сумки	cумка zara новая	сумки zara новая
богажники	багажники	богажники мицубиси	багажники мицубиси
dax	dac	samsung dax	samsung dac
антена	антенна	антена lte	антенна lte
xonor	honor	xonor 9lite	honor 9lite
колпаки	коляски	solaris колпаки	solaris коляски
mishel	michael	mishel	michael
obermayer	obermeyer	obermayer	obermeyer
yfcnbk	настил	yfcnbk	настил
kit	kia	quick-step repair kit	quick-step repair kia
mersedes	mercedes	mersedes cls amg	mercedes cls amg
teak	team	teak house	team house
phablet	tablet	phablet	tablet
marsedes	mersedes	marsedes	mersedes
англиский	английский	англиский бульдог купить	английский бульдог купить
мобил	мобиль	бесплатно мобил	бесплатно мобиль
cty	cry	cty 1035	cry 1035
рефрежиратор	рефрижератор	авто рефрежиратор	авто рефрижератор
авс	абс	блок авс фьюжен	блок абс фьюжен
glj	glk	glj	glk
nes	new	nes картриджи	new картриджи
squier	super	squier standart stratocaster	super standart stratocaster
ваты	воды	аппарат для сахарной ваты	аппарат для сахарной воды
fabian	fabiani	fabian	fabiani
port	ford	mini display port dvi	mini display ford dvi
акумулятор	аккумуляторы	акумулятор r520 m	аккумуляторы r520 m
купэ	кпп	ford fiesta mk6 дверь купэ	ford fiesta mk6 дверь кпп
platronics	plantronics	platronics voyager	plantronics voyager
blanc	black	бокс на крышу mont blanc	бокс на крышу mont black
lend	led	акомулятор lend rover	акомулятор led rover
ван	ванну	мебель ван гог	мебель ванну гог
ранец	баней	gulliver ранец	gulliver баней
tuareg	touareg	volkswagen tuareg 2009 крышка	volkswagen touareg 2009 крышка
photon	foton	burton photon	burton foton
рей	рио	r16 х рей	r16 х рио
olimpus	olympus	olimpus диктофон	olympus диктофон
taco	tako	taco	tako
компьютор	компьютер	бортовой компьютор ваз	бортовой компьютер ваз
ame	amg	ame-сигнализация	amg-сигнализация
катридж	картриджи	canon катридж	canon картриджи
тверь	дверь	айфон 8 тверь	айфон 8 дверь
база	без	база рыбалка	без рыбалка
ака	око	ака сигнум	око сигнум
samsug	samsung	samsug tab 2	samsung tab 2
bwm	bmw	bwm x3	bmw x3
stilet	stiletto	patron stilet	patron stiletto
антена	антенны	антена на даче	антенны на даче
akai	kia	akai 325	kia 325
бмх	бмв	бмх haro	бмв haro
xtr	чек	shimano xtr m9020	shimano чек m9020
termaltake	thermaltake	termaltake versa u 21	thermaltake versa u 21
bls	plus	fl 42 bls	fl 42 plus
pazollini	pazolini	pazollini новые 36	pazolini новые 36
купер	купе	акпп купер	акпп купе
гдн	гдр	100 гдн-3	100 гдр-3
планет	планшет	r14 амтел планет	r14 амтел планшет
аурус	таурус	авто таета аурус купить б у	авто таета таурус купить б у
заводска	заводская	бмв х3 f25 заводска тонировкп	бмв х3 f25 заводская тонировкп
садовод	садовый	алтайский садовод	алтайский садовый
cohen	john	jacob cohen размер 35	jacob john размер 35
бив	бмв	бив 5	бмв 5
crs	cts	crs 1 d	cts 1 d
стеклоподемников	стеклоподъемников	блок кнопок стеклоподемников	блок кнопок стеклоподъемников
корбка	коробка	passat b7 корбка	passat b7 коробка
нисан	диван	спиральный провод нисан кашкай	спиральный провод диван кашкай
автомойчик	автомойщик	автомойчик	автомойщик
акира	акура	акира жк	акура жк
port	ford	ford 2 0 л split port	ford 2 0 л split ford
kruz	cruz	santa kruz	santa cruz
мотоцил	мотоцикл	амортизатор на мотоцил	амортизатор на мотоцикл
gjl	под	gjlcnfdrf gjl rhjccjdsq	gjlcnfdrf под rhjccjdsq
ладо	лада	автомобиль ладо гранта	автомобиль лада гранта
балет	браслет	classic балет бумага	classic браслет бумага
mitsubihi	mitsubishi	recaro mitsubihi	recaro mitsubishi
hearty	hearts	hearty rise halcyon	hearts rise halcyon
pioner	pioneer	pioner 4 3	pioneer 4 3
yota	toyota	yota swift	toyota swift
aser	acer	aser intel core i7	acer intel core i7
amt	amg	amt e2	amg e2
bmv	bmw	bmv 630	bmw 630
harmon	kardon	harmon	kardon
molo	polo	molo свитшот	polo свитшот
isb	usb	isb брюки	usb брюки
eve	evo	eve roche	evo roche
шуроповерт	шуруповерты	milwaukee шуроповерт 12	milwaukee шуруповерты 12
део	дэу	блок двигателя део нексия	блок двигателя дэу нексия
бартер	бампер	бартер на пассат	бампер на пассат
кренометр	хронометр	mitsubishi кренометр	mitsubishi хронометр
свечи	двери	honda civic свечи	honda civic двери
ghjabkmyfz	профильная	nhe f ghjabkmyfz	nhe f профильная
vish	wish	vish	wish
cub	cube	cub cadet 524 swe	cube cadet 524 swe
dey	day	dey matiz	day matiz
апарат	аппарат	апарат игрушек	аппарат игрушек
atb	atv	stels atb 500 h	stels atv 500 h
амартизаторы	амортизатора	амартизаторы mazda 3 ford	амортизатора mazda 3 ford
volp	voip	volp	voip
cherri	chery	cherri tiggo	chery tiggo
ассенизаторная	ассенизатора	ассенизаторная машина	ассенизатора машина
брем	боем	а брем жизнь животных 4 и 5 том	а боем жизнь животных 4 и 5 том
squier	super	squier jazz bass vintage modified 70 s	super jazz bass vintage modified 70 s
аненки	пленки	аненки	пленки
domo	demo	domo	demo
бартавой	бортовой	бартавой компьютер	бортовой компьютер
yamaran	yamaha	yamaran s350	yamaha s350
решотка	решётки	решотка на w205	решётки на w205
алюминивый	алюминиевый	багажник алюминивый	багажник алюминиевый
aim	sim	farpoint aim controller	farpoint sim controller
mca	mac	mca 52-64-148-kt 14	mac 52-64-148-kt 14
мираж	мира	авантис мираж 7	авантис мира 7
artego	atego	artego	atego
ark	mark	ark benefit m 4	mark benefit m 4
cuboid	cubot	cuboid	cubot
cute	cut	yamaha cute	yamaha cut
сaddy	caddy	volkswagen сaddy	volkswagen caddy
nfxrf	тачка	nfxrf	тачка
miratti	meratti	miratti	meratti
war	air	call of duty world at war 2	call of duty world at air 2
акомулятор	аккумулятор	акомулятор 12v	аккумулятор 12v
платина	плата	tiffany кольцо платина	tiffany кольцо плата
некся	нексию	авто разбор некся матор 16	авто разбор нексию матор 16
cтол	стол	cтол офисный	стол офисный
volksvagen	volkswagen	volksvagen transporter	volkswagen transporter
будка	сумка	daf lf будка	daf lf сумка
абхазкие	абхазские	абхазкие	абхазские
merlen	merlin	merlen	merlin
гос	час	555 гос номера	555 час номера
матиз	машин	аренда дэу матиз	аренда дэу машин
акула	школа	акула из икея	школа из икея
р-он	район	алтайский край завьяловский р-он	алтайский край завьяловский район
lev	levi	lev	levi
mater	master	alma mater	alma master
rive	river	rive gauche	river gauche
stine	stone	stine	stone
samaung	samsung	samaung note 3	samsung note 3
hop	shop	батут happy hop б у	батут happy shop б у
блатные	элитные	блатные номеры	элитные номеры
melian	meilan	melian	meilan
алюминевые	алюминиевые	алюминевые сходни	алюминиевые сходни
nord	ford	nord electro 3	ford electro 3
lamborgini	lamborghini	tonino lamborgini	tonino lamborghini
калину	машину	бартер на калину	бартер на машину
beast	best	brave beast	brave best
vfg	vag	danfoss vfg 2 15	danfoss vag 2 15
ресталинг	рестайлинг	212 ресталинг капот	212 рестайлинг капот
human	man	detroit become human обмен	detroit become man обмен
san	sony	san might	sony might
diver	drive	bs diver exel	bs drive exel
ymaha	yamaha	ymaha basic jog	yamaha basic jog
автомагнитолла	автомагнитола	автомагнитолла vw tiguan	автомагнитола vw tiguan
рублевая	рулевая	10 ти рублевая монета	10 ти рулевая монета
ока	окна	бампера на ока	бампера на окна
adelette	adilette	adidas adelette	adidas adilette
murella	marella	murella	marella
кулачки	кулак	bison кулачки	bison кулак
дпм	дом	dpm дпм	dpm дом
теном	тентом	батарея с теном	батарея с тентом
akai	kia	akai pro lpk25 25	kia pro lpk25 25
котедж	коттедж	аренда котедж	аренда коттедж
nfrcb	такси	djlbntkm nfrcb	djlbntkm такси
skyzone	skyline	skyzone	skyline
hohner	honor	hohner b2	honor b2
venza	benz	venza шлейф	benz шлейф
тверь	дверь	50 лет октября тверь	50 лет октября дверь
kercher	karcher	kercher k5 20	karcher k5 20
huyndai	hyundai	huyndai creta	hyundai creta
гдн	гдр	6 гдн	6 гдр
bvr	dvr	bvr danfoss	dvr danfoss
hyndai	hyundai	hyndai i 35	hyundai i 35
gree	green	gree 18 бу	green 18 бу
jcb	usb	jcb 1	usb 1
leeco	lego	leeco le x 527	lego le x 527
awg	amg	awg 650	amg 650
двиготеля	двигателя	hyundai i40 крышка двиготеля	hyundai i40 крышка двигателя
canton	canon	canton dm 55	canon dm 55
esprado	esprimo	esprado	esprimo
запчас	запчасть	айфоны 6 на запчас	айфоны 6 на запчасть
pavillion	pavilion	hp pavillion tx 2000	hp pavilion tx 2000
спортаже	спортаж	багажник на крышу киа спортаже	багажник на крышу киа спортаж
бензо	бензин	бензо датчик камри	бензин датчик камри
блины	плиты	блины для штанги обрезиненные	плиты для штанги обрезиненные
instamax	instax	instamax	instax
глина	плита	воронеж глина	воронеж плита
колпаки	коляски	opel astra колпаки	opel astra коляски
радитор	радиатор	радитор отопителний на bmw34	радиатор отопителний на bmw34
vgs	vga	vgs cobra	vga cobra
kinergy	energy	hankook tire kinergy	hankook tire energy
huyndai	hyundai	huyndai elantra 2010	hyundai elantra 2010
bolevard	boulevard	suzuki bolevard	suzuki boulevard
malagutti	malaguti	malagutti	malaguti
xtrail	x-trail	nissan xtrail t30 стеклоподъемника	nissan x-trail t30 стеклоподъемника
хэчбэк	хетчбэк	nissan primera p12 хэчбэк	nissan primera p12 хетчбэк
stark	smart	stark 20 1 s	smart 20 1 s
алюминевая	алюминиевая	алюминевая лестница 3 метра	алюминиевая лестница 3 метра
witch	watch	ni no kuni wrath of the white witch	ni no kuni wrath of the white watch
bose	bosch	акустика bose инфинити	акустика bosch инфинити
шруз	шрусы	шруз внутрений правый аккорд 7	шрусы внутрений правый аккорд 7
xkey	key	xkey 360	key 360
nice	nike	nice 10	nike 10
titans	titan	crash of the titans	crash of the titan
перед	передач	амортизатор перед nissan	амортизатор передач nissan
lend	led	toyota lend cruiser 200 телевизор	toyota led cruiser 200 телевизор
аккумуляторный	аккумуляторы	аккумуляторный ударный гайковерт makita dtw1002z	аккумуляторы ударный гайковерт makita dtw1002z
steam	stels	steam controller беспроводной	stels controller беспроводной
тоета	тойота	2 лт тоета	2 лт тойота
hdi	hdmi	hdi 308	hdmi 308
rhino	hino	saitek x-55 rhino	saitek x-55 hino
bmv	bmw	bmv x4 зимние колеса	bmw x4 зимние колеса
cmc	gmc	cmc	gmc
svho	sho	yamaha fx cruiser svho	yamaha fx cruiser sho
hair	air	5 braun hair satin	5 braun air satin
galaxi	galaxy	samsung galaxi tab pro	samsung galaxy tab pro
боц	бой	боц 7x50	бой 7x50
fnc	атс	fnc	атс
лайтер	катер	базз лайтер история игрушек	базз катер история игрушек
бартер	мастер	бартер на кирпич буханка	мастер на кирпич буханка
crono	chrono	crono	chrono
renge	range	renge rover 4	range rover 4
аммортизатор	амортизатора	bmw аммортизатор 34	bmw амортизатора 34
база	без	база отдыха инчхе	без отдыха инчхе
бартер	мастер	бартер холл	мастер холл
дск	диск	ао дск	ао диск
зарядник	зарядное	батарейка и зарядник шуруповерты bosch	батарейка и зарядное шуруповерты bosch
апарат	аппарата	апарат высокого давления москва	аппарата высокого давления москва
besta	vesta	ikea besta	ikea vesta
пинчер	принтер	аффен пинчер	аффен принтер
airbeg	airbag	airbeg t4	airbag t4
seed	speed	kia seed sw	kia speed sw
-двигатель	двигатель	-двигатель фольксваген 9а	двигатель фольксваген 9а
ops	ips	elite ops	elite ips
боты	болты	dainese мото боты	dainese мото болты
btc	htc	btc 9051h cheetah	htc 9051h cheetah
купэ	кпп	w140 купэ	w140 кпп
www	wwe	www avito ru donlombard	wwe avito ru donlombard
fara	zara	fara	zara
hudra	hydra	hudra beauty	hydra beauty
logitec	logitech	logitec k400	logitech k400
базы	без	базы для рассылки писем	без для рассылки писем
hyavei	hyawei	hyavei	hyawei
родиатор	радиатор	родиатор фронтера	радиатор фронтера
yfcnjkmysq	настольный	yfcnjkmysq aen jk	настольный aen jk
open	opel	toyo open country a-t	toyo opel country a-t
плота	плата	балон для спасательного плота	балон для спасательного плата
акуммулятор	акумуляторы	акуммулятор для шуруповерта интерскол	акумуляторы для шуруповерта интерскол
soni	sony	soni playstation 3 red	sony playstation 3 red
краснадарский	краснодарский	авито краснадарский край	авито краснодарский край
корса	колёса	блок управления опель корса	блок управления опель колёса
iwhatch	whatch	iwhatch	whatch
маркус	марку	ikea маркус	ikea марку
alien	klein	qcyber alien	qcyber klein
ling	king	long ling	long king
galla	gala	galla dance	gala dance
cherry	chery	cherry amulet дверь передняя	chery amulet дверь передняя
калесо	калесы	merida заднее калесо	merida заднее калесы
x-box	xbox	mortal kombat x-box 360	mortal kombat xbox 360
корвет	ковер	35 ас 208 корвет	35 ас 208 ковер
волк	волос	белый волк	белый волос
molo	polo	molo плавки	polo плавки
electra	elantra	graco contour electra deluxe	graco contour elantra deluxe
мульти	пульт	makita мульти	makita пульт
psy	psu	psy	psu
cic	ice	cic джойстик	ice джойстик
ltr	lte	ltr 450	lte 450
поршни	пороги	бмв поршни m57n	бмв пороги m57n
ланос	насос	авто разбор шевроле ланос	авто разбор шевроле насос
куга	киа	бампер передний форд куга	бампер передний форд киа
teket	tiket	teket	tiket
spiker	speaker	ice spiker	ice speaker
подьеник	подъемник	авто подьеник вышка	авто подъемник вышка
samaung	samsung	samaung 5s	samsung 5s
onda	honda	onda 989	honda 989
тди	ауди	1 9 тди насос	1 9 ауди насос
решотка	решётка	bmw 1 f 20 решотка радиатора	bmw 1 f 20 решётка радиатора
саната	соната	аренда авто под такси саната	аренда авто под такси соната
ixus	asus	canon ixus 150	canon asus 150
samsungj	samsung	samsungj	samsung
bmv	bmw	6hp21 bmv	6hp21 bmw
перефаратор	префоратор	аренда перефаратор	аренда префоратор
shark	smart	paul shark s	paul smart s
чихол	чехол	samsung galaxy s8 plus чихол	samsung galaxy s8 plus чехол
карат	гараж	1 карат сережки	1 гараж сережки
kenda	honda	26 2 35 kenda	26 2 35 honda
коровка	коробка	божья коровка инерционная	божья коробка инерционная
авуди	авди	авуди а 8 2007 4 2 л	авди а 8 2007 4 2 л
yemaxa	yamaxa	yemaxa	yamaxa
lamps	lanos	flame lamps	flame lanos
болер	вольер	болер для ванны	вольер для ванны
mei	msi	love mei	love msi
audio	audi	art audio lab p135ex	art audi lab p135ex
суточно	срочно	адлер квартира по суточно	адлер квартира по срочно
alpinstars	alpinestars	alpinstars durban	alpinestars durban
convers	converse	convers off white	converse off white
родстер	роутер	smart родстер	smart роутер
ecobaby	ergobaby	ecobaby oasis	ergobaby oasis
honir	honer	honir 8	honer 8
peoneer	pioner	peoneer 2 din	pioner 2 din
starck	shark	starck	shark
panasonik	panasonic	panasonik cf-30 блок	panasonic cf-30 блок
xonar	honor	asus xonar essence	asus honor essence
молот	золото	браслет молот тора	браслет золото тора
бизнесс	бизнесе	бизнесс в махачкале	бизнесе в махачкале
марта	карта	8 марта	8 карта
saints	santa	saints row 3	santa row 3
антена	антенну	антена радиостанций	антенну радиостанций
тигровый	торговый	астрильд тигровый	астрильд торговый
мелки	мешки	crayola мелки	crayola мешки
кател	качели	аристон кател	аристон качели
амартизаторы	амортизатора	амартизаторы на ваз 2114	амортизатора на ваз 2114
tuscan	tucson	tom ford tuscan leather	tom ford tucson leather
-прицеп	прицеп	автодом-прицеп	автодом прицеп
bike	nike	y bike	y nike
nord	ford	nord drum 2	ford drum 2
кватиры	квартиру	2 кватиры	2 квартиру
spec	space	d1 spec	d1 space
doodge	dodge	doodge caliber	dodge caliber
автомобил	автомобилей	автосалон автомобил	автосалон автомобилей
per	for	per una женские	for una женские
бестселер	бестселлер	бестселер центр теле2	бестселлер центр теле2
bmx	bmw	bmx 4130	bmw 4130
бартер	мастер	бартер на буханку	мастер на буханку
адаптор	адаптер	iphone наушники адаптор	iphone наушники адаптер
аефон	аифон	аефон 8sбу	аифон 8sбу
бош	бак	автомойки бош	автомойки бак
lucia	lumia	lucia oriflame	lumia oriflame
база	без	база для дип-34а	без для дип-34а
energi	energy	michelin energi	michelin energy
двоих	двух	браслеты на двоих	браслеты на двух
магнитафон	магнитофон	бмв е65 магнитафон	бмв е65 магнитофон
вилки	диски	амортизационные вилки	амортизационные диски
audio	audi	monitor audio bronze b6	monitor audi bronze b6
iphon	iphone	iphon 7plus	iphone 7plus
toyo	toyota	205 60 r16 toyo c1s	205 60 r16 toyota c1s
aven	avent	aven	avent
bmx	bmw	bmx	bmw
ipone	iphone	ipone 7 рст	iphone 7 рст
fokus	focus	fokus 2 универсал	focus 2 универсал
zenfon	zenfone	zenfon 2 экран	zenfone 2 экран
huindai	hundai	huindai santa fe запчасти	hundai santa fe запчасти
ideacenter	ideacentre	ideacenter	ideacentre
aqua	asus	guerlain aqua allegoria lys soleia франция	guerlain asus allegoria lys soleia франция
nex	nexia	sony nex vg30	sony nexia vg30
предохронителей	предохранителей	блок предохронителей ваз 2114	блок предохранителей ваз 2114
iphom	iphon	iphom	iphon
двигател	двигателей	авторазбор киров двигател ваз	авторазбор киров двигателей ваз
onda	honda	onda v919 3g air	honda v919 3g air
sefora	sephora	sefora	sephora
камод	комод	антикварный камод для посуды	антикварный комод для посуды
vantage	vintage	vantage	vintage
автомобил	автомобиле	автомобил в красноярский	автомобиле в красноярский
кварцит	кварц	камень кварцит черный	камень кварц черный
амартизаторы	амортизатора	амартизаторы на приору	амортизатора на приору
falcone	falcon	falcone	falcon
huyndai	hyundai	huyndai veloster	hyundai veloster
stag	star	stag 400	star 400
cts	gtx	cadillac cts капот	cadillac gtx капот
глина	плита	бетонитовая глина	бетонитовая плита
pod	ipod	line hd pod 300	line hd ipod 300
kit	kia	fuji kit	fuji kia
wolksvagen	volkswagen	wolksvagen passat b 5	volkswagen passat b 5
бабуркина	бабушкина	бабуркина 11	бабушкина 11
ljk	дол	ljk fycrfz	дол fycrfz
huyndai	hyundai	huyndai santa fe 3	hyundai santa fe 3
крови	кровати	биохимический анализатор крови	биохимический анализатор кровати
сиид	сид	бампер задний на киа сиид	бампер задний на киа сид
arista	ariston	arista switch	ariston switch
mersedes	mercedes	бендикс mersedes	бендикс mercedes
copin	copine	copin	copine
мета	места	алкотестер мета 01	алкотестер места 01
kit	kia	samsung evolution kit	samsung evolution kia
electra	elantra	harley davidson electra	harley davidson elantra
стоп	стол	w211 стоп сигнал	w211 стол сигнал
красоты	работы	администратор салона красоты москва	администратор салона работы москва
jcb	usb	аренда jcb 3cx	аренда usb 3cx
toms	tom	toms мужские	tom мужские
wag	vag	автомастер wag	автомастер vag
rein	rain	rein zinn	rain zinn
бандо	бандаж	victoria s secret бандо 2017	victoria s secret бандаж 2017
акватрон	акватон	акватрон	акватон
der	ddr	der g house	ddr g house
kinergy	energy	hankook kinergy eco k425	hankook energy eco k425
affiniti	affinity	britax affiniti	britax affinity
storm	sport	norco storm 6 3	norco sport 6 3
hyudai	hyundai	hyudai tucson	hyundai tucson
asic	asus	miner asic	miner asus
айфое	айфон	айфое 7	айфон 7
usm	usb	canon ef 40 2 8 usm	canon ef 40 2 8 usb
магнитоллы	магнитолы	адаптер для магнитоллы	адаптер для магнитолы
акумулятор	аккумулятора	акумулятор б у купить	аккумулятора б у купить
mara	zara	max mara cube	max zara cube
rac	rca	hitachi rac	hitachi rca
fat	fiat	jillette fat boy	jillette fiat boy
brita	britax	brita	britax
бомбер	бампер	бомбер лен	бампер лен
раптор	трактор	автомаляр раптор	автомаляр трактор
motolend	motoland	motolend 150 скутер	motoland 150 скутер
holidays	holiday	barbie happy holidays	barbie happy holiday
bmx	bmw	bmx в казани	bmw в казани
motorolla	motorola	motorolla mpx220	motorola mpx220
бомбер	бампер	бомбер 3xl	бампер 3xl
спортейж	спортаж	разборка киа спортейж	разборка киа спортаж
аккумуляторный	аккумуляторы	аккумуляторный воздушный компрессор	аккумуляторы воздушный компрессор
jourdan	jordan	jourdan	jordan
еловый	новый	байкальский тракт п еловый	байкальский тракт п новый
audio	audi	audio technica ath-ag1x	audi technica ath-ag1x
zzx	zzr	zzx	zzr
акумулятор	аккумулятора	samsung акумулятор	samsung аккумулятора
greco	graco	greco ss-600	graco ss-600
анттена	антенна	анттена	антенна
бетонит	бентонит	бетонит	бентонит
huosyng	hyosung	huosyng	hyosung
база	без	база отдыха тургояк	без отдыха тургояк
ромео	ровер	альфа ромео 147 разборка	альфа ровер 147 разборка
huyndai	hyundai	huyndai tucson салон	hyundai tucson салон
asp	esp	asp	esp
зафира	защита	бачок расширительный опель зафира b	бачок расширительный опель защита b
bose	bosch	bose oe2i	bosch oe2i
audio	audi	resolution audio	resolution audi
fred	ford	fred rogers	ford rogers
ben	benz	ben sherman харрингтон	benz sherman харрингтон
обьектив	объективы	обьектив 18 для nikon	объективы 18 для nikon
бочок	бачок	бочок омывателя киа сид	бачок омывателя киа сид
ixus	asus	canon ixus 285	canon asus 285
ваты	воды	аппарат сладкой ваты cf 1	аппарат сладкой воды cf 1
чероки	широки	акпп на гранд чероки 1995	акпп на гранд широки 1995
baits	beats	zip baits rigge 70	zip beats rigge 70
usm	usb	canon ef 28mm f 1 8 usm	canon ef 28mm f 1 8 usb
плойка	плитка	moser плойка	moser плитка
vtx	gtx	vtx аморт	gtx аморт
mim	mix	fender jazz bass mim	fender jazz bass mix
jsb	usb	jsb мини эксковатор	usb мини эксковатор
ягода	года	ягода	года
higline	highline	бампер tiguan higline	бампер tiguan highline
amaia	alaia	amaia	alaia
кая	киа	ninjago кая	ninjago киа
rech	tech	george rech	george tech
ride	red	continental ride tour 27 5	continental red tour 27 5
indie	indigo	bumbleride indie 2016	bumbleride indigo 2016
некси	нексию	бензонасос на дэу некси	бензонасос на дэу нексию
интренет	интернет	безлимитный интренет	безлимитный интернет
спейс	спец	бампер спейс стар	бампер спец стар
hakkapeliita	hakkapeliitta	255 60 18 hakkapeliita	255 60 18 hakkapeliitta
vebasto	webasto	vebasto помпа	webasto помпа
мерсадес	мерседес	мерсадес 212 блок фара	мерседес 212 блок фара
marny	marni	marny	marni
acura	astra	багажник acura rdx	багажник astra rdx
sandro	sandero	sandro платье	sandero платье
богажника	багажнике	kia ceed sw универсал крышка богажника	kia ceed sw универсал крышка багажнике
disel	diesel	nissan disel	nissan diesel
ариада	аренда	ариада бу	аренда бу
dlink	link	dlink 2230	link 2230
perfume	parfum	giesso perfume	giesso parfum
train	trail	train sim	trail sim
romet	romeo	romet	romeo
баю	баню	афалина баю бай	афалина баню бай
tor	tour	vertex tor	vertex tour
апарат	аппарату	апарат толстамер	аппарату толстамер
артемова	артемов	артемова 7	артемов 7
simens	siemens	simens a35	siemens a35
rolex	rover	rolex часы механика	rover часы механика
aser	acer	aser v3-772	acer v3-772
chevrole	chevrolet	chevrole aveo	chevrolet aveo
bello	bell	mie bello	mie bell
crysler	chrysler	crysler concord запчасти	chrysler concord запчасти
lanser	lancer	hot wheels lanser	hot wheels lancer
антены	антенны	антены рации	антенны рации
minelabe	minelab	minelabe ctx3030	minelab ctx3030
xiomi	xiaomi	xiomi mi a1	xiaomi mi a1
bmv	bmw	bmv 7 серии	bmw 7 серии
jeremy	jetem	adidas jeremy	adidas jetem
бади	боди	бади	боди
бартер	мастер	бартер 21099	мастер 21099
апарат	аппараты	апарат автомат	аппараты автомат
toyo	toyota	toyo r 888	toyota r 888
презд	поезда	братский презд	братский поезда
ibox	xbox	ibox f1	xbox f1
кардан	карта	ssangyong kyron кардан	ssangyong kyron карта
кросовки	кроссовка	кросовки гель женские	кроссовка гель женские
ауди-	ауди	ауди-100 1983 в	ауди 100 1983 в
cannon	canon	cannon ef 50mm 1 1 4	canon ef 50mm 1 1 4
x-touch	touch	behringer x-touch universal	behringer touch universal
матор	моторы	kia bongo матор	kia bongo моторы
jammer	hammer	jammer	hammer
cikx	kicx	cikx	kicx
idl	idol	indesit idl 60	indesit idol 60
extrem	extreme	asus maximus vi extrem	asus maximus vi extreme
leeco	lego	leeco экран	lego экран
картин	квартир	багетные рамы для картин	багетные рамы для квартир
zenfon	zenfone	asus zenfon	asus zenfone
vi-fi	wi-fi	vi-fi	wi-fi
tdi	audi	акпп audi q7 6 0 tdi	акпп audi q7 6 0 audi
gfkfc	палас	gfkfc	палас
ektra	extra	ektra	extra
анализатор	катализатор	анализатор холестерина	катализатор холестерина
sims	sim	sims одежда	sim одежда
фитнесс	фитнеса	баланс фитнесс	баланс фитнеса
хёндай	хундай	бампер на хёндай акцент	бампер на хундай акцент
lady	lada	lady look платье	lada look платье
блетус	блютус	блетус колонка	блютус колонка
galetto	galletto	galetto	galletto
redmy	redmi	xiaomi redmy 4	xiaomi redmi 4
asta	astra	opel asta gts j	opel astra gts j
магнум	магнит	автобокс на крышу магнум 300	автобокс на крышу магнит 300
astro	astra	garmin astro 320 бу	garmin astra 320 бу
домик	домом	schleich домик	schleich домом
боевая	новая	боевая 133	новая 133
sanyo	sony	sanyo ncr18650ga 3500mah	sony ncr18650ga 3500mah
larte	arte	larte	arte
back	black	ju ju be right back	ju ju be right black
батильоны	ботильоны	батильоны белые	ботильоны белые
фарсунки	форсунки	1az fse фарсунки	1az fse форсунки
аксесуары	аксессуара	аксесуары на пег перего татамия	аксессуара на пег перего татамия
akai	kia	akai mpk 225	kia mpk 225
acura	astra	acura mdx 2010 14	astra mdx 2010 14
акуумулятор	акумулятор	акуумулятор на телефон	акумулятор на телефон
astron	aston	astron	aston
бра	пара	бра хрустальные бронзовые	пара хрустальные бронзовые
gtr	gtx	kawasaki gtr 1400 concours	kawasaki gtx 1400 concours
kalvin	klein	kalvin klein футболки женские	klein klein футболки женские
анна	ванна	анна рубль	ванна рубль
pucci	gucci	emilio pucci сумка	emilio gucci сумка
бензаносос	бензонасос	бензаносос на форд 3	бензонасос на форд 3
барбари	барбара	барбари	барбара
cic	ice	джойстик bmw e60 cic	джойстик bmw e60 ice
щоссе	шоссе	боровская щоссе	боровская шоссе
benetint	benefit	benetint	benefit
hzljv	рядом	hzljv c djljq	рядом c djljq
xonar	honor	xonar pci-e	honor pci-e
ipon	ipod	ipon 7	ipod 7
samsyng	samsung	samsyng gear sport s2	samsung gear sport s2
sdi	cdi	sdi	cdi
бош	бак	акб бош	акб бак
вариатор	радиатор	mitsubishi вариатор	mitsubishi радиатор
салярис	солярис	тормозные диски на салярис задние	тормозные диски на солярис задние
куга	киа	ford куга r18	ford киа r18
utythfnjh	генератор	utythfnjh typbyjdsq	генератор typbyjdsq
yokogama	yokohama	yokogama geolandar g033	yokohama geolandar g033
filly	fila	filly лошадки	fila лошадки
полики	полки	gx470 полики	gx470 полки
акумулятор	аккумулятор	акумулятор iphone 7 plus	аккумулятор iphone 7 plus
nan	nano	nan кисломолочный 1	nano кисломолочный 1
tommi	tommy	tommi hilfiger парка	tommy hilfiger парка
алюминивая	алюминевая	алюминивая бочка	алюминевая бочка
бочонки	бочки	бочонки пивные	бочки пивные
гениратор	генератора	астра гениратор	астра генератора
focal	focus	focal performance ps 165 f	focus performance ps 165 f
didricsons	didriksons	didricsons	didriksons
речной	ручной	1 комнатная квартира на речной	1 комнатная квартира на ручной
аксесуары	аксессуара	аксесуары на ваз 2107	аксессуара на ваз 2107
splinter	sprinter	splinter cell 3ds	sprinter cell 3ds
bone	one	bone	one
addidas	adidas	addidas 95	adidas 95
литье	платье	vw литье диски r16	vw платье диски r16
diezel	diesel	zic diezel	zic diesel
пастельные	постельное	атласные пастельные белье	атласные постельное белье
hörmann	hormann	hörmann	hormann
таета	сайта	в москве машины на продажу таета камри	в москве машины на продажу сайта камри
аккомулятор	аккумулятор	аккомулятор milwaukee	аккумулятор milwaukee
wolksvagen	volkswagen	wolksvagen b 5	volkswagen b 5
cruise	cruze	215 65 16 amtel cruise	215 65 16 amtel cruze
атракционов	аттракционов	администратор атракционов	администратор аттракционов
серебрянный	серебряный	аккумулятор серебрянный	аккумулятор серебряный
босаножки	босоножки	босаножки сиреневые	босоножки сиреневые
апарат	аппараты	апарат выского давления мойка	аппараты выского давления мойка
ais	ace	nikkor 35mm ais	nikkor 35mm ace
mjx	max	mjx x101	max x101
parke	parker	parke ronen	parker ronen
sister	duster	paul joe sister	paul joe duster
репитер	ресивер	wi fi репитер	wi fi ресивер
серато	серого	блок стеклоподъемников на киа серато	блок стеклоподъемников на киа серого
ekc	elc	ekc 603505	elc 603505
cruser	cruiser	pt cruser фара правая	pt cruiser фара правая
hanza	hansa	hanza	hansa
тойта	тойоту	акпп тойта королла	акпп тойоту королла
картина	квартира	анемоны картина	анемоны квартира
марта	карта	8 марта 92	8 карта 92
беж	без	босоножки оригинал беж 38	босоножки оригинал без 38
азанатор	азонатор	азанатор	азонатор
фризе	фреза	бишон фризе щенки	бишон фреза щенки
lessie	lassie	lessie 134	lassie 134
river	rover	river island ботинки	rover island ботинки
mikra	micra	mikra	micra
toyo	toyota	205 55 r16 toyo j48	205 55 r16 toyota j48
phill	phil	phill jones	phil jones
mag	max	mag safe 60w	max safe 60w
бензанасос	бензонасос	бензанасос газ 53	бензонасос газ 53
stark	smart	stark surfer	smart surfer
diver	drive	diver automatic	drive automatic
подьемники	подъемники	авто подьемники	авто подъемники
леви	левая	бмв тройка паваротник передни леви	бмв тройка паваротник передни левая
sander	sandero	sander z	sandero z
sex	srx	sex dolls	srx dolls
lene	lenne	lene ветровка	lenne ветровка
аккумуляторный	аккумуляторы	аккумуляторный dyson	аккумуляторы dyson
ymaha	yamaha	ymaha mt	yamaha mt
fane	face	fane studio 12b 12 8 ohm	face studio 12b 12 8 ohm
sheld	shield	nvidia sheld	nvidia shield
tayota	toyota	tayota vista	toyota vista
капри	капот	adidas капри	adidas капот
vello	velo	vello	velo
станжаровская	санжаровская	елена станжаровская	елена санжаровская
стилы	стиле	ботинки стилы	ботинки стиле
акамулятор	аккумулятор	акамулятор квадрокоптера	аккумулятор квадрокоптера
аверлок	оверлок	аверлок	оверлок
creator	cerato	lego creator	lego cerato
uliss	ulysse	uliss nardin executive	ulysse nardin executive
port	ford	gigabit 8 port	gigabit 8 ford
six	aux	electric six	electric aux
аккамулятор	аккумулятора	аккамулятор для детской машины	аккумулятора для детской машины
ибн	ибп	абу али ибн сина	абу али ибп сина
gree	green	gree bora	green bora
pod	ipad	pod hd500	ipad hd500
bmv	bmw	bmv 5 серия	bmw 5 серия
антена	антенна	антена радиостанции	антенна радиостанции
yamaxa	yamaha	yamaxa fzr 400	yamaha fzr 400
joby	moby	joby штатив	moby штатив
матиз	машин	бампер дэу матиз передний	бампер дэу машин передний
laney	line	laney lx20r	line lx20r
альберт	альмера	альберт камалеева	альмера камалеева
acura	astra	acura mdx противотуманки	astra mdx противотуманки
плата	платье	socket 1366 материнская плата	socket 1366 материнская платье
плакат	пакет	god of war плакат	god of war пакет
apolo	apollo	apolo	apollo
шанель	газель	балетки шанель оригинал	балетки газель оригинал
lumina	lumia	kappa lumina	kappa lumia
анна	ванна	анна богдан	ванна богдан
snow	sony	lol snow angel	lol sony angel
квартра	квартиры	1 комнатная квартра	1 комнатная квартиры
шуроповерт	шуруповерта	aeg шуроповерт акомулятор	aeg шуруповерта акомулятор
les	led	les paul studio	led paul studio
сосна	окна	барный стул сосна	барный стул окна
sex	srx	better than sex	better than srx
хондай	хундай	бампер на хондай акцент б у	бампер на хундай акцент б у
афра	афро	афра косы	афро косы
svt	cvt	svt 13	cvt 13
беговой	бытовой	беговой дорожки ремонт	бытовой дорожки ремонт
гелия	геля	баллоны для гелия	баллоны для геля
ingersol	ingersoll	ingersol часы	ingersoll часы
метан	металл	балоны на метан бу	балоны на металл бу
альфард	альфа	бампер на тойота альфард	бампер на тойота альфа
бричстоун	бриджстоун	б-у бричстоун спорт 15 195 55	б-у бриджстоун спорт 15 195 55
форс	форд	force форс	force форд
козы	кожи	англонубийские козы	англонубийские кожи
akty	acty	honda akty	honda acty
beni	benz	bebe beni	bebe benz
stark	smart	stark fat 26 2	smart fat 26 2
squier	super	fender squier bullet trem blk	fender super bullet trem blk
soni	sony	soni playstation 1	sony playstation 1
share	shure	fujifilm instax share	fujifilm instax shure
таблетки	балетки	бассейн таблетки	бассейн балетки
теней	детей	аппликаторы для теней	аппликаторы для детей
ego	evo	samsung s9402 ego	samsung s9402 evo
maktek	maktec	maktek	maktec
bmv	bmw	ангельские глазки bmv	ангельские глазки bmw
ltd	led	ltd ta	led ta
мотоцыкла	мотоцикл	бак для мотоцыкла	бак для мотоцикл
боевая	новая	боевая 34	новая 34
плата	платья	ryzen материнская плата	ryzen материнская платья
-trail	x-trail	blazer-trail-trailblazer-sailun-трайл	blazer x-trail-trailblazer-sailun-трайл
rolan	ronal	rolan	ronal
kelvin	klein	kelvin klein	klein klein
polk	polo	polk audio tsi	polo audio tsi
canton	canon	canton chrono	canon chrono
gerry	geely	gerry veber	geely veber
metall	metal	metall gear solid the legacy	metal gear solid the legacy
норд	форд	автобокс норд	автобокс форд
побегом	пробегом	авто с побегом	авто с пробегом
poc	fox	poc горнолыжный	fox горнолыжный
wfr	vfr	wfr 2841	vfr 2841
citizen	citroen	citizen attesa	citroen attesa
басейна	бассейна	аксессуары для басейна	аксессуары для бассейна
pinco	pink	i pinco pallino	i pink pallino
эхо	эко	бензокоса эхо	бензокоса эко
hhd	hdd	hhd 1 tb	hdd 1 tb
pery	peri	pery	peri
vector	vectra	vector снегоход	vectra снегоход
enjoi	enjoy	enjoi	enjoy
картридер	картридж	mlg4 картридер	mlg4 картридж
dtx	gtx	dtx 1800	gtx 1800
taser	laser	taser	laser
duall	dual	microsoft 640 duall	microsoft 640 dual
sanata	sonata	hyundai sanata 5 тагаз	hyundai sonata 5 тагаз
nicon	nikon	nicon d5100	nikon d5100
бартер	мастер	бартер каркас	мастер каркас
beat	bit	beat pro	bit pro
redial	radial	michelin redial xse	michelin radial xse
buster	duster	buster прицеп	duster прицеп
bits	beats	bits	beats
kavasaki	kawasaki	kavasaki kx450f	kawasaki kx450f
афоня	афон	афоня	афон
trustmaster	thrustmaster	trustmaster	thrustmaster
kicx	kia	kicx 1 350	kia 1 350
бартер	мастер	бартер на авто в казани	мастер на авто в казани
комбенизон	комбинезон	crockid комбенизон	crockid комбинезон
aphone	phone	aphone x	phone x
str	star	sho-me g-700 str	sho-me g-700 star
ihpone	iphone	ihpone x	iphone x
ewt	eqt	electrolux ewt	electrolux eqt
при	три	бетономешалка при	бетономешалка три
агломиратор	агломератор	агломиратор	агломератор
maximo	massimo	morel maximo coax 6x9	morel massimo coax 6x9
ротор	мотор	xt ротор	xt мотор
nemezis	nemeziz	adidas nemezis	adidas nemeziz
атс	птс	атс cisco	птс cisco
алюминевый	алюминиевый	алюминевый кузов	алюминиевый кузов
стоп	стол	citroen c4 стоп	citroen c4 стол
обарудование	оборудования	б у амиачные холодельное обарудование	б у амиачные холодельное оборудования
рефрижиратор	рефрижератор	isuzu рефрижиратор	isuzu рефрижератор
inglezina	inglesina	inglezina espresso	inglesina espresso
kaльян	кальян	kaльян	кальян
not	note	redmi not 4	redmi note 4
astro	astra	astro a 40	astra a 40
аксесуары	аксессуара	аксесуары в детскую	аксессуара в детскую
бартер	бампер	бартер на iphone 5s	бампер на iphone 5s
dogee	doogee	dogee	doogee
tcx	tech	ботинки для мото tcx	ботинки для мото tech
six	aux	tom clancy rainbow six	tom clancy rainbow aux
fred	ford	fred perry обувь	ford perry обувь
амок	замок	амок	замок
cayin	canon	cayin ha-1a	canon ha-1a
квадрациклов	квадроциклов	ремонт квадрациклов тюмень	ремонт квадроциклов тюмень
матор	мотора	бмв е66 матор	бмв е66 мотора
бош	бак	бош 797	бак 797
автор	авито	автор работ	авито работ
планер	пионер	f3k планер	f3k пионер
бобер	ковер	бобер капюшоном	ковер капюшоном
olimpus	olympus	адаптер для olimpus	адаптер для olympus
ввс	все	ботинки ввс ссср	ботинки все ссср
covrt	covert	5 11 covrt 18	5 11 covert 18
кэрри	керри	kerry кэрри	kerry керри
comander	commander	детский квадроцикл comander 125dd	детский квадроцикл commander 125dd
дика	диски	2 дика 15	2 диски 15
sanny	sunny	nissan sanny b15	nissan sunny b15
salmon	salomon	salmon queen	salomon queen
hjps	розы	hjps	розы
аккамулятор	аккумулятора	аккамулятор samsung s6	аккумулятора samsung s6
kicx	kia	kicx tornado sound x1	kia tornado sound x1
start	sport	dynamic 420 start	dynamic 420 sport
абмен	обмен	абмен на полный привод	обмен на полный привод
laser	lancer	canon laser base mf 3110	canon lancer base mf 3110
микрарайоне	микрорайон	1 квартира в микрарайоне оплата за месяц	1 квартира в микрорайон оплата за месяц
boogaboo	bugaboo	boogaboo twin	bugaboo twin
xone	one	allen heath xone	allen heath one
афтомобиль	автомобиль	афтомобиль газел воронеж	автомобиль газел воронеж
стеклоподьемника	стеклоподъемник	блок управления стеклоподьемника кия рио	блок управления стеклоподъемник кия рио
плата	платье	6s материнская плата	6s материнская платье
aristone	ariston	aristone 30	ariston 30
бвгажник	багажник	бвгажник	багажник
rybi	rubi	rybi	rubi
красоты	работы	аренда кресла в салоне красоты	аренда кресла в салоне работы
yokogama	yokohama	yokogama 215 55r17	yokohama 215 55r17
динская	детская	база динская	база детская
rfv	кам	peugeot 406 двигатель rfv	peugeot 406 двигатель кам
coty	city	vanilla fields coty	vanilla fields city
банм	бани	банм	бани
exelent	excellent	fighter exelent	fighter excellent
cic	ice	cic e70	ice e70
navigation	navigator	ps navigation	ps navigator
mersedes	mercedes	mersedes benz clk	mercedes benz clk
mersedes	mercedes	mersedes slk r170	mercedes slk r170
sanyo	sony	sanyo plc xp50	sony plc xp50
vtc	мес	evic vtc mini	evic мес mini
yamaxa	yamaha	yamaxa fjr 1300	yamaha fjr 1300
аксесуары	аксессуара	аксесуары для шиномонтажа	аксессуара для шиномонтажа
orange	range	orange pi	range pi
жилет	лет	marella жилет	marella лет
обьектив	объектив	canon 550 обьектив	canon 550 объектив
метан	металл	агзс метан	агзс металл
антена	антенна	антена для wi fi	антенна для wi fi
fsr	far	stumpjumper fsr comp	stumpjumper far comp
audio	audi	dvd audio 5 1	dvd audi 5 1
bad	ipad	breaking bad delay	breaking ipad delay
автомобил	автомобиль	автомобил арка	автомобиль арка
gll	glk	bosch gll 3-80 c	bosch glk 3-80 c
war	air	god of war комиксы	god of air комиксы
поясная	пояса	osprey поясная сумка	osprey пояса сумка
lessie	lassie	lessie suprafill	lassie suprafill
muji	muzi	muji	muzi
игроков	игровой	автографы игроков фк динамо	автографы игровой фк динамо
prx	pro	prx 33	pro 33
kona	sony	kona горный	sony горный
zed	led	zed-fuul	led-fuul
блиница	блинница	блиница бу	блинница бу
tein	twin	tein mitsubishi	twin mitsubishi
xanter	hunter	xanter	hunter
sumsung	samsung	sumsung a5 2016	samsung a5 2016
avp	avc	danfoss avp	danfoss avc
металург	металлург	металург 56	металлург 56
brtf	икеа	rhjdfnm brtf	rhjdfnm икеа
mathercare	mothercare	mathercare новая	mothercare новая
uterqe	uterque	uterqe сумка	uterque сумка
bars	bar	bars 250r	bar 250r
аквалайн	акваланг	аквалайн-170	акваланг-170
cfylfkb	сандали	cfylfkb tycrbt	сандали tycrbt
бмх	бмв	большие бмх	большие бмв
битум	битый	битум 90	битый 90
bga	vga	bga трафарет	vga трафарет
carp	car	avid carp	avid car
ass	asus	wild ass	wild asus
ipone	iphone	ipone 7 64	iphone 7 64
cумка	сумки	cумка reebok	сумки reebok
bmv	bmw	bmv m-ask	bmw m-ask
rase	race	велосипед для взрослых merida road rase 903-18 2008	велосипед для взрослых merida road race 903-18 2008
автомагнитолла	автомагнитола	автомагнитолла андроид	автомагнитола андроид
pra	pro	toyota pra	toyota pro
балгарка	болгарку	балгарка dewalt	болгарку dewalt
war	air	god of war iv ps4	god of air iv ps4
аккомулятор	аккумулятор	аккомулятор 12в	аккумулятор 12в
linkoln	lincoln	linkoln town car	lincoln town car
wolksvagen	volkswagen	wolksvagen passat b5 1 9tdi	volkswagen passat b5 1 9tdi
бидэ	биде	бидэ	биде
types	type-c	types	type-c
akura	acura	akura mdx	acura mdx
molo	polo	molo mini a ture	polo mini a ture
steam	stels	steam ключи	stels ключи
свечи	двери	свечи накаливания boshe	двери накаливания boshe
vigore	vigor	vigore	vigor
pegeot	peugeot	pegeot 206 rc	peugeot 206 rc
после	шоссе	автомобиль после пожара	автомобиль шоссе пожара
челси	чулки	37 5 челси	37 5 чулки
boch	bosch	villeroy boch made in luxembourg	villeroy bosch made in luxembourg
решотка	решетки	бамперный решотка	бамперный решетки
зарядник	зарядки	батарейка зарядник	батарейка зарядки
botega	bottega	botega veneta	bottega veneta
акумулятор	аккумулятор	акумулятор на катер	аккумулятор на катер
tuareg	touareg	tuareg тормозные диски	touareg тормозные диски
ltd	led	esp ltd m 400	esp led m 400
теана	ткань	багажник задний бампер ниссан теана 31	багажник задний бампер ниссан ткань 31
антена	антенну	антена приора	антенну приора
бмх	бмв	бмх будённовск	бмв будённовск
laurel	lauren	laurel новый	lauren новый
stunt	sound	mbk stunt	mbk sound
care	zara	baby care daily	baby zara daily
dvr	dvd	dvr камера для android	dvd камера для android
нерабочая	рабочая	asus eee pc клавиатура нерабочая	asus eee pc клавиатура рабочая
каропка	каробка	ауди 100 автомат каропка передач	ауди 100 автомат каробка передач
бари	бани	бари тарханова	бани тарханова
свечи	двери	toyota tundra свечи	toyota tundra двери
saints	santa	saints	santa
esx	eos	esx 480	eos 480
kicx	kia	kicx 1600	kia 1600
рассроску	рассрочку	авто в рассроску	авто в рассрочку
вилки	диски	адаптер под конусный шток вилки	адаптер под конусный шток диски
камютер	кампютер	бартовой камютер	бартовой кампютер
gjc	пос	gjc ysq	пос ysq
audio	audi	cambridge audio d 500	cambridge audi d 500
смола	столы	dental смола	dental столы
каленвал	коленвал	каленвал brp rxp	коленвал brp rxp
nexiq	nexia	nexiq	nexia
onda	honda	onda v975	honda v975
huyndai	hyundai	huyndai hd120 стартер	hyundai hd120 стартер
база	без	база foofoo	без foofoo
obf	obd	w463 obf	w463 obd
lasetti	lacetti	ferrum pribor lasetti	ferrum pribor lacetti
cony	sony	cony	sony
пропан	продам	балоны пропан	балоны продам
аккомулятор	аккумулятор	аккомулятор к ноутбуку	аккумулятор к ноутбуку
комплит	комплект	бмх комплит	бмх комплект
dac	mac	moonshadow crescent dsd dac es9038pro	moonshadow crescent dsd mac es9038pro
volswagen	volkswagen	volswagen golf 2002	volkswagen golf 2002
jac	jack	jac n 120	jack n 120
blasterx	blaster	sound blasterx h7	sound blaster h7
бартер	мастер	бартер на 15 торусы	мастер на 15 торусы
vitess	vitesse	vitess новая	vitesse новая
хаммер	размер	амортизатор хаммер	амортизатор размер
nisa	nysa	nisa	nysa
sline	line	бампер a6 c7 sline	бампер a6 c7 line
tokina	nokia	tokina 90mm	nokia 90mm
str	star	str-de427	star-de427
бассейная	бассейна	бассейная 5	бассейна 5
xonda	honda	xonda 1000 xx	honda 1000 xx
паз	газ	кордан на паз дизель	кордан на газ дизель
trace	space	trace elliot brat	space elliot brat
fate	fat	fate amouage	fat amouage
тупика	туника	аренда ж д тупика пути	аренда ж д туника пути
раз	газ	басаножки лак 40 раз	басаножки лак 40 газ
spectrum	spectra	nike spectrum	nike spectra
sangyong	ssangyong	sangyong stavic	ssangyong stavic
petrocanada	petro-canada	petrocanada	petro-canada
nyx	max	nyx пудра	max пудра
pma	puma	denon pma 700v	denon puma 700v
nex	max	nex 3n	max 3n
sonyo	sanyo	sonyo	sanyo
тигр	игр	ахатина ахатина тигр	ахатина ахатина игр
вентелятора	вентилятора	блок управления вентелятора вольво	блок управления вентилятора вольво
botmaster	boatmaster	botmaster 310k	boatmaster 310k
dlink	d-link	dlink ip	d-link ip
aura	air	rico aura	rico air
баторейки	батарейки	баторейки	батарейки
магнитоллы	магнитол	santa fe рамка магнитоллы	santa fe рамка магнитол
японцы	япония	автомат японцы	автомат япония
алюминевые	алюминиевый	алюминевые окна бу	алюминиевый окна бу
hyunday	hyundai	hyunday solaris колпак	hyundai solaris колпак
rolf	golf	viktor rolf	viktor golf
peoneer	pioner	peoneer 40	pioner 40
аккустика	акустика	аккустика yamaha	акустика yamaha
micado	mikado	micado	mikado
плата	платья	gigabyte материнская плата сокет am3	gigabyte материнская платья сокет am3
дикси	диски	бокалы из дикси	бокалы из диски
aerpods	airpods	aerpods	airpods
nex	max	minolta af nex	minolta af max
uncarted	uncharted	uncarted 4 ps4	uncharted 4 ps4
смд	сид	блок цилиндров смд 14	блок цилиндров сид 14
x-box	xbox	x-box one s 500gb	xbox one s 500gb
prim	prime	prim body	prime body
акумулятор	аккумулятора	акумулятор для телефона fly	аккумулятора для телефона fly
нисан	диван	бокс на крышу нисан	бокс на крышу диван
безиборд	бизиборд	безиборд	бизиборд
бмх	бмв	бмх игрушка	бмв игрушка
haven	heaven	adidas haven black	adidas heaven black
стан	штаны	3 комнатная тёплый стан	3 комнатная тёплый штаны
козлики	кролики	альпийской нубийские козлики	альпийской нубийские кролики
tone	one	classic tone	classic one
акуумулятор	аккумулятор	акуумулятор 6 в	аккумулятор 6 в
kingstone	kingston	usb kingstone 64 gb	usb kingston 64 gb
siii	iii	samsung siii	samsung iii
clone	stone	lego clone	lego stone
audio	audi	cambridge audio d	cambridge audi d
lfx	дач	xu7jb lfx	xu7jb дач
малька	мальчика	coppens для малька	coppens для мальчика
сука	сумка	американская акита ркф сука	американская акита ркф сумка
стилус	стиле	samsung galaxy note 10 1 стилус	samsung galaxy note 10 1 стиле
аккамулятор	аккумуляторе	аккамулятор для погрузчика	аккумуляторе для погрузчика
выкупим	купим	авто в аренду под такси с выкупим	авто в аренду под такси с купим
t-s	ats	235 70 16 yokohama geolander i t-s g073	235 70 16 yokohama geolander i ats g073
pasat	passat	volksvagen pasat	volksvagen passat
flacon	falcon	flacon	falcon
fis	fish	elan slx fis plate	elan slx fish plate
xstore	store	xstore	store
mml	mmi	metalmaster mml 2870	metalmaster mmi 2870
bmx	bmw	bmx стресс	bmw стресс
aqua	asus	chanel aqua	chanel asus
gaia	kia	cult gaia	cult kia
baggy	buggy	baggy	buggy
коп	кпп	3 коп 1902	3 кпп 1902
kics	kicx	kics 1 1000	kicx 1 1000
vira	vita	rant vira	rant vita
vba	миф	vba программист	миф программист
mihelin	michelin	mihelin primacy hp 215 55 16	michelin primacy hp 215 55 16
wolksvagen	volkswagen	wolksvagen passat 1 8 2013	volkswagen passat 1 8 2013
rolex	rover	rolex original	rover original
соленойд	соленоиды	5r55w соленойд	5r55w соленоиды
toyta	toyota	toyta d4	toyota d4
керпич	кирпичи	б у керпич красный	б у кирпичи красный
loe	leo	loe bonamassa	leo bonamassa
вариатор	радиатор	t31 вариатор	t31 радиатор
сузуки	сумки	авторазборка сузуки сх4	авторазборка сумки сх4
gattioni	gattinoni	gattioni	gattinoni
roam	roan	giant roam 3	giant roan 3
alfare	allure	alfare allergy	allure allergy
анализатор	катализатор	анализатор сигналов	катализатор сигналов
атлендер	аутлендер	атлендер	аутлендер
gti	gtx	gti гольф 5	gtx гольф 5
акамулятор	аккумулятор	lg l7 акамулятор	lg l7 аккумулятор
нерабочий	рабочий	hdd нерабочий	hdd рабочий
uplay	play	htc uplay	htc play
бартер	бампер	стройматериалы бартер на недвижимость	стройматериалы бампер на недвижимость
toyo	toyota	toyo proxes r20 275 40	toyota proxes r20 275 40
eastpack	eastpak	eastpack	eastpak
samyung	samyang	samyung	samyang
typ	type	typ 210	type 210
valeo	volvo	valeo 2655023	volvo 2655023
бочок	бачок	w 210 бочок стеклоомывателя	w 210 бачок стеклоомывателя
аммортизатор	амортизатора	аммортизатор шкода октавия а7	амортизатора шкода октавия а7
поршни	пороги	поршни ford focus 3 2 0	пороги ford focus 3 2 0
антена	антенну	антена kia	антенну kia
панно	ванной	большое панно на стену	большое ванной на стену
трубная	труба	2-х комнатная трубная	2-х комнатная труба
porche	porsche	porche 918 spyder	porsche 918 spyder
форд-	форд	битые форд-фокус 1	битые форд фокус 1
богажника	багажнике	богажника	багажнике
tehnika	technica	audio tehnika	audio technica
акуумуляторы	аккумулятор	акуумуляторы от ноутбуков	аккумулятор от ноутбуков
hofman	hofmann	балансировочный станок hofman	балансировочный станок hofmann
shevrolet	chevrolet	shevrolet cobalt	chevrolet cobalt
шипы	шины	бахилы зимние шипы hooper	бахилы зимние шины hooper
hundai	hyundai	hundai 78	hyundai 78
mersedes	mercedes	mersedes w129	mercedes w129
storm	sport	wileyfox storm 3	wileyfox sport 3
for	ford	tea for two	tea ford two
tos	eos	tos станок фрезерный	eos станок фрезерный
arden	green	elizabeth arden sunflowers	elizabeth green sunflowers
toyo	toyota	toyo 195 55 15	toyota 195 55 15
totota	toyota	totota corolla 1998	toyota corolla 1998
городок	город	1-к комнатная лесной городок	1-к комнатная лесной город
vector	vectra	vector 48 gt	vectra 48 gt
gthajhfnjh	перфоратор	gthajhfnjh	перфоратор
корса	колеса	авто запчасти на опель корса	авто запчасти на опель колеса
kobalt	cobalt	chevrolet kobalt	chevrolet cobalt
samaung	samsung	samaung tab 10	samsung tab 10
nessa	nexia	nessa nissan r	nexia nissan r
aero	air	active aero	active air
seni	sony	seni 1	sony 1
дождевые	дождевик	reima штаны дождевые	reima штаны дождевик
апарат	аппарата	апарат для маникюра stronge	аппарата для маникюра stronge
gks	gls	bosch gks 65	bosch gls 65
treal	trial	treal	trial
антена	антенну	антена диполь	антенну диполь
roze	rose	turaidas roze	turaidas rose
кросовки	кроссовки	geox кросовки	geox кроссовки
miu	mini	miu miu 37	mini mini 37
база	без	автокресло база family	автокресло без family
длительно	длительный	дом снять в сочи длительно	дом снять в сочи длительный
gsc	gsx	gsc	gsx
itdhjkt	шевроле	itdhjkt fdtj	шевроле fdtj
pmp	psp	prestigio pmp 3007	prestigio psp 3007
ifhone	ipone	ifhone 4s	ipone 4s
chantal	chanel	thomass chantal	thomass chanel
авосервис	автосервис	авосервис	автосервис
аккомуляторный	аккумуляторный	аккомуляторный триммер	аккумуляторный триммер
шаверма	шаурма	аппарат грилы доя шаверма бу	аппарат грилы доя шаурма бу
mono	mini	diorshow fusion mono	diorshow fusion mini
fls	gls	ardo fls 105	ardo gls 105
асистент	ассистент	асистент без опыта работы	ассистент без опыта работы
каре	карт	hermes каре	hermes карт
oktavia	octavia	oktavia mpi	octavia mpi
смола	столы	бочки эпоксидная смола	бочки эпоксидная столы
shtorm	storm	geo shtorm	geo storm
аммортизаторы	амортизатор	аммортизаторы импреза	амортизатор импреза
hundai	hyundai	hundai accent verna	hyundai accent verna
плата	платье	k53sv материнская плата	k53sv материнская платье
автомрбиль	автомобили	автомрбиль	автомобили
база	без	база алтай	без алтай
denton	denon	denton target	denon target
extrime	xtreme	rampage extrime	rampage xtreme
irbiz	irbis	irbiz	irbis
nvidea	nvidia	nvidea geforce 710	nvidia geforce 710
ixus	asus	ixus 285 hs	asus 285 hs
gbn	gbh	gbn fqrb	gbh fqrb
akai	kia	akai 630	kia 630
кот	год	бирманский кот	бирманский год
белорус	беларусь	купить цепи на белорус	купить цепи на беларусь
грязевые	грузовые	35 колеса грязевые	35 колеса грузовые
xaiomi	xiaomi	xaiomi redmi note 5 4 64 gb	xiaomi redmi note 5 4 64 gb
водный	водой	1 комн водный мир	1 комн водой мир
машинные	машины	машинные колонки 10	машины колонки 10
botega	bottega	botega veneta сумка	bottega veneta сумка
зид	зил	амортизатор зид курьер	амортизатор зил курьер
niel	neil	niel barret	neil barret
белка	балка	белка чернобурка	балка чернобурка
care	zara	pampers premium care трусики 4	pampers premium zara трусики 4
mtr	mtb	mtr denelli	mtb denelli
решотка	решетка	kia sportage решотка	kia sportage решетка
rader	rider	scala rader	scala rider
scoot	scooter	stokke scoot v3 текстиль	stokke scooter v3 текстиль
aqua	asus	philips aqua	philips asus
spin	pin	acer spin 3	acer pin 3
касса	класса	pos касса	pos класса
lauder	lauren	lauder double	lauren double
war	air	god of war playstation 2	god of air playstation 2
houme	home	zara houme	zara home
blg	big	blg блок цилиндров	big блок цилиндров
bmcx	bmx	bmcx	bmx
scoot	scooter	razor two dirt scoot	razor two dirt scooter
башкири	башкирии	башкири	башкирии
arv	atv	arv 168	atv 168
tdx	trx	tdx 5	trx 5
асы	часы	асы	часы
dap	dsp	dap 1320	dsp 1320
porshe	porsche	porshe 911 turbo	porsche 911 turbo
bluray	blu-ray	samsung bluray	samsung blu-ray
audio	audi	mac audio ice fire 225	mac audi ice fire 225
nicon	nikon	nicon d3100	nikon d3100
rih	rich	bork ap rih 1960 bk	bork ap rich 1960 bk
lady	lada	dior lady	dior lada
kerher	karcher	kerher мойка	karcher мойка
ymc	jmc	ymc	jmc
альпайн	алпайн	альпайн магнитола 2din	алпайн магнитола 2din
toni	tiny	be be toni	be be tiny
болер	вольер	болер электро	вольер электро
гир	кир	ремешок для часов самсунг гир 3	ремешок для часов самсунг кир 3
soni	sony	soni xperia tablet z 4	sony xperia tablet z 4
tuareg	touareg	tuareg фаркоп	touareg фаркоп
stars	star	jackson stars warrior	jackson star warrior
астрахова	страховка	астрахова	страховка
акумулятор	аккумуляторе	акумулятор а3 2017	аккумуляторе а3 2017
btwin	twin	btwin mistigirl	twin mistigirl
galaxi	galaxy	samsung galaxi a3 2016	samsung galaxy a3 2016
dsguared	dsquared	dsguared куртка	dsquared куртка
dgs	dsg	dgs 3100	dsg 3100
бензо	бензин	бензо бак опель	бензин бак опель
suprim	supreme	suprim	supreme
сауна	салона	аренда дом сауна	аренда дом салона
ymaha	yamaha	ymaha 125	yamaha 125
tayota	toyota	tayota land cruiser 100	toyota land cruiser 100
jcb	usb	jcb 3sx super	usb 3sx super
waio	vaio	sony waio duo 13	sony vaio duo 13
carneliani	corneliani	carneliani	corneliani
motolend	motoland	motolend atv 250s	motoland atv 250s
шеврале	шевроле	акпп шеврале эпика	акпп шевроле эпика
акумулятор	аккумулятора	акумулятор redmi 4	аккумулятора redmi 4
сливной	личной	бачек сливной	бачек личной
strom	storm	susuki v strom 650	susuki v storm 650
бартер	бампер	бартер на сантехнику	бампер на сантехнику
аккамулятор	аккумуляторы	аккамулятор ipad air	аккумуляторы ipad air
les	led	les belles de ricci liberte acidulee	led belles de ricci liberte acidulee
архипоосиповка	архипо-осиповка	архипоосиповка	архипо-осиповка
басейн	бассейны	басейн детский	бассейны детский
бачек	бачке	бачек от унитаза	бачке от унитаза
сузуки	сумки	гофры на сузуки	гофры на сумки
roces	rover	roces 175	rover 175
бассет	рассел	бассет хаунд вязка	рассел хаунд вязка
бартер	мастер	бартер на ваз	мастер на ваз
cowon	canon	cowon e	canon e
hds	hdd	hds 558 c	hdd 558 c
ped	pad	go ped	go pad
gearz	gears	gearz	gears
cybve	сниму	cybve	сниму
did	dvd	did тело	dvd тело
viessman	viessmann	viessman насос	viessmann насос
gefoce	geforce	gefoce 210	geforce 210
микрафоны	микрофоны	беспроводные микрафоны	беспроводные микрофоны
wiu	wii	wiu 100	wii 100
higscreen	highscreen	higscreen power	highscreen power
late	lite	macbook pro 15 late 2008	macbook pro 15 lite 2008
картер	карты	акпп картер	акпп карты
англиский	английский	англиский бульдог	английский бульдог
шаран	гараж	тюнинг для фольксваген шаран	тюнинг для фольксваген гараж
баффер	бафер	баффер	бафер
vtx	gtx	vtx	gtx
коники	коньки	20 тонн коники	20 тонн коньки
акумулятор	аккумулятор	акумулятор на шуруповерт интерскол	аккумулятор на шуруповерт интерскол
candy	camry	maclaren volo dylans candy bar	maclaren volo dylans camry bar
brazer	blazer	two brazer	two blazer
sub	usb	canton sub	canton usb
bom	boom	bom box	boom box
lexsus	nexus	lexsus gs350 4 фары	nexus gs350 4 фары
bmx	bmw	bmx седушка	bmw седушка
гд-	гдн	6 гд-4	6 гдн 4
georg	george	jensen georg	jensen george
dlink	link	dlink 2210	link 2210
назад	мазда	22 дня назад	22 дня мазда
метан	металл	transit метан	transit металл
автокомпресор	автокомпрессор	автокомпресор	автокомпрессор
новоросийск	новороссийск	банки новоросийск	банки новороссийск
плов	полов	блюдо под плов	блюдо под полов
cheroke	cherokee	jeep grand cheroke wj привод передний	jeep grand cherokee wj привод передний
боллер	бойлеры	боллер горизонтальный	бойлеры горизонтальный
боксерки	боксерские	боксерки 44-45 размер	боксерские 44-45 размер
gad	god	pontoon-21 gad gancho	pontoon-21 god gancho
ланос	насос	битый авто ланос	битый авто насос
lossi	losi	lossi	losi
алюминевые	алюминиевое	алюминевые заготовки	алюминиевое заготовки
braslet	bracelet	braslet	bracelet
rjah	кофр	rjah	кофр
бигиль	бигль	бигиль	бигль
hundai	hyundai	hundai ix35 автомобиль	hyundai ix35 автомобиль
kenda	honda	kenda 20	honda 20
атирадар	антирадар	атирадар	антирадар
xxxx	xxx	bauer vapor xxxx	bauer vapor xxx
rjat	кофе	rjat	кофе
басейн	бассейны	басейн интекс	бассейны интекс
mersedes	mercedes	mersedes c разбор	mercedes c разбор
титан	диван	thule touring 200 титан	thule touring 200 диван
fitnes	fitness	fitnes	fitness
smw	bmw	smw	bmw
samsumg	samsung	samsumg 7	samsung 7
cor	acer	cor 5	acer 5
modal	model	modal	model
soni	sony	mp3 плеер soni	mp3 плеер sony
trv	trw	arctic cat 700 trv cruizer	arctic cat 700 trw cruizer
база	без	база make up	без make up
bosh	bosch	bosh перфоратор	bosch перфоратор
абонимент	абонемент	бассейн абонимент	бассейн абонемент
ворот	город	автоматика для сдвижных ворот	автоматика для сдвижных город
дону	дом	автомобили ростовна дону авомоли	автомобили ростовна дом авомоли
сьезда	съезда	26 сьезда кпсс	26 съезда кпсс
стеклоподьемника	стеклоподъемника	блок управления стеклоподьемника на ниссан	блок управления стеклоподъемника на ниссан
lune	line	de lune рюкзаки	de line рюкзаки
add	and	add женский пуховик	and женский пуховик
camaro	camry	camaro 2002	camry 2002
мерседесс	мерседес	двигатель мерседесс мл 164	двигатель мерседес мл 164
банер	бампер	банер для стройки	бампер для стройки
ikon	iron	ikon sub mkii	iron sub mkii
venetta	veneta	мужская мокасины venetta	мужская мокасины veneta
ista	insta	ista bmw	insta bmw
ifone	iphone	ifone 7 plus	iphone 7 plus
bosh	bosch	bosh benvenuto	bosch benvenuto
nexx	next	nexx nf-345	next nf-345
тюннинг	тюнинг	polo тюннинг	polo тюнинг
addidas	adidas	босоножки addidas	босоножки adidas
матрикс	матрица	хундай матрикс кулак правый	хундай матрица кулак правый
for	ford	need for speed payback ps4	need ford speed payback ps4
sargo	targa	sargo	targa
istudio	studio	istudio	studio
karl	carlo	karl lagerfeld сумка	carlo lagerfeld сумка
акуумулятор	аккумуляторы	акуумулятор щелочной	аккумуляторы щелочной
mad	max	mad men	max men
tdi	audi	audi a4 1 9 tdi	audi a4 1 9 audi
вмв	бмв	акпп вмв	акпп бмв
запчачсти	запчасти	venza запчачсти	venza запчасти
molo	polo	molo blue	polo blue
atomik	atomic	norco atomik	norco atomic
asic	asus	asic майнер l3 580 mh s	asus майнер l3 580 mh s
lauder	lauren	este lauder este	este lauren este
дифузор	диффузора	outlander дифузор	outlander диффузора
супорт	суппорт	infiniti fx35 супорт	infiniti fx35 суппорт
optimus	optima	lg optimus vu p895	lg optima vu p895
бордачок	бардачок	бордачок	бардачок
cts	gtx	cadillac cts радиатор	cadillac gtx радиатор
пит	плит	амортизатор на пит	амортизатор на плит
flp	flip	flp	flip
gir	gear	samsung gir vr	samsung gear vr
akai	kia	akai renesans	kia renesans
отель	модель	апарт отель мини отель гостиница	апарт модель мини модель гостиница
соски	диски	avent соски	avent диски
фанарь	фонаря	gle фанарь	gle фонаря
гидроскутера	гироскутер	батарея для гидроскутера	батарея для гироскутер
tpass	pass	tpass	pass
dxm	dmx	numark dxm	numark dmx
pull	polo	pull and bear mom	polo and bear mom
toyta	toyota	toyta trueno	toyota trueno
асистент	ассистент	асистент	ассистент
водный	водой	баллон водный	баллон водой
сцеление	сцепление	газель сцеление	газель сцепление
фанарь	фонари	range rover vogue 3 фанарь задний	range rover vogue 3 фонари задний
yamaxa	yamaha	yamaxa bws	yamaha bws
плата	платье	zte blade l3 плата	zte blade l3 платье
hyndai	hyundai	hyndai sonata 2016 дверь	hyundai sonata 2016 дверь
база	без	база отдыха с озером	без отдыха с озером
банпера	бампер	банпера	бампер
арбакасы	абаркасы	арбакасы	абаркасы
idtqyfz	швейная	idtqyfz	швейная
huindai	hyundai	huindai elantra бензобак	hyundai elantra бензобак
баннер	бампер	баннер черный	бампер черный
forge	force	forge vag	force vag
late	lite	macbook pro 13 late 2011	macbook pro 13 lite 2011
lulu	lol	lulu paris	lol paris
баночки	банок	баночки мясные	банок мясные
omax	max	omax since	max since
fvabnjy	амфитон	fvabnjy	амфитон
gtl	gti	k 1600 gtl	k 1600 gti
soni	sony	soni playstation 4 аренда	sony playstation 4 аренда
alkatel	alcatel	alkatel one touch idol	alcatel one touch idol
акумулятор	аккумуляторе	акумулятор hitachi	аккумуляторе hitachi
зафира	защита	багажник на опель зафира	багажник на опель защита
антены	антенна	антены спутниковые тарелки	антенна спутниковые тарелки
хол	угол	блек хол	блек угол
cover	rover	silicon cover s9	silicon rover s9
window	windows	nokia window	nokia windows
hunday	hyundai	безопастность hunday i30	безопастность hyundai i30
айфрн	айфоны	айфрн 5	айфоны 5
angeleye	angeles	angeleye ae603	angeles ae603
port	ford	air port express	air ford express
x-lane	x-line	kio x-lane	kio x-line
арматурная	арматура	арматурная сетка	арматура сетка
стеклоподьемниками	стеклоподъемниками	блок управления стеклоподьемниками пежо 406	блок управления стеклоподъемниками пежо 406
römer	romer	britax römer baby-safe	britax romer baby-safe
каропка	каробка	volvo s 80 каропка	volvo s 80 каробка
word	ford	the giant word book	the giant ford book
pops	pop	alcatel pops	alcatel pop
колектор	коллектора	3sgte колектор	3sgte коллектора
приборка	приборы	honda cb 400 приборка	honda cb 400 приборы
aire	air	aire loco loewe	air loco loewe
ndx	hdx	ndx	hdx
per	for	per perego детский стульчик	for perego детский стульчик
avto	avito	avto омск	avito омск
hvl-	hvl	hvl-60	hvl 60
плата	платье	acer aspire 5920g материнская плата	acer aspire 5920g материнская платье
ангорский	ангарский	ангорский	ангарский
немерная	мерная	арматура немерная ф 12	арматура мерная ф 12
lorensi	lorenzi	lorensi	lorenzi
защитник	защитный	защитник бампера bmw f30	защитный бампера bmw f30
база	без	maxi cosi fix база	maxi cosi fix без
супорты	суппорты	супорты ваз классика	суппорты ваз классика
апорат	апарат	апорат для шавермы	апарат для шавермы
camper	cooper	camper обувь	cooper обувь
нет	нкт	iphone 8 коробки нет	iphone 8 коробки нкт
sylvia	silvia	sylvia natterer	silvia natterer
bad	ipad	vw golf 4 bad	vw golf 4 ipad
bose	bosch	bose комплект audi a6	bosch комплект audi a6
kit	kia	inglezina kit auto	inglezina kia auto
xtr	чек	itp xtr	itp чек
бартер	мастер	бартер калина	мастер калина
богажника	багажника	2111 крышка богажника	2111 крышка багажника
mysso	musso	ssangyong mysso	ssangyong musso
pegeot	peugeot	pegeot 5008	peugeot 5008
citroën	citroen	бампер citroën	бампер citroen
ldjqyb	двойни	rjkzcrf lkz ldjqyb	rjkzcrf lkz двойни
six	aux	kona stinky six	kona stinky aux
mersedes	mercedes	mersedes benz 140	mercedes benz 140
балет	балетки	большой балет	большой балетки
benli	benly	honda benli	honda benly
pas	pad	босоножки pas de	босоножки pad de
кот	год	белый кот не кастрирован	белый год не кастрирован
zenfon	zenfone	asus zenfon 3 deluxe	asus zenfone 3 deluxe
bock	book	otto bock 28r16	otto book 28r16
delongi	delonghi	delongi ecam 22 360	delonghi ecam 22 360
rabota	kubota	https www avito ru ekaterinburg rabota s_trg 6	https www avito ru ekaterinburg kubota s_trg 6
moët	moet	moët	moet
автомобил	автомобиле	автомобил спробегом	автомобиле спробегом
scart	smart	scart sega	smart sega
squier	super	squier classic vibe	super classic vibe
акамулятор	аккумулятор	акамулятор колонки jbl	аккумулятор колонки jbl
белова	беговая	белова 12	беговая 12
карину	картину	дверь передняя правая на карину 97года	дверь передняя правая на картину 97года
бочька	бочка	бочька 3 куба	бочка 3 куба
водонепронецаемая	водонепроницаемая	акустика водонепронецаемая	акустика водонепроницаемая
vanos	lanos	vanos s50	lanos s50
сузуки	сумки	бензобак на сузуки	бензобак на сумки
hts	htc	hts моноблок	htc моноблок
forza	corsa	forza motorsport 1	corsa motorsport 1
orang	orange	абонемент orang	абонемент orange
хондай	хундай	бампер задний оригинал хондай солярис 2	бампер задний оригинал хундай солярис 2
хиельницкого	хмельницкого	богдана хиельницкого	богдана хмельницкого
buggi	buggy	mountain buggi nano	mountain buggy nano
six	aux	tom clancys rainbow six	tom clancys rainbow aux
subary	subaru	subary xv	subaru xv
lachetti	lacetti	chevrolet lachetti седан	chevrolet lacetti седан
xenon	canon	expander xenon	expander canon
nissin	nissan	nissin tourer	nissan tourer
имобилайзер	иммобилайзера	nissan x-trail t31 имобилайзер	nissan x-trail t31 иммобилайзера
ymaha	yamaha	ymaha наклейка	yamaha наклейка
rjkkb	колли	rjkkb	колли
droid	android	moto z droid	moto z android
борода	города	борода на оку	города на оку
boch	bosch	villeroy boch бу	villeroy bosch бу
контенер	контейнеры	контенер с холодинико	контейнеры с холодинико
spasio	spacio	corolla spasio	corolla spacio
ava	eva	michael kors ava оригинал	michael kors eva оригинал
indie	indigo	bumbleride indie новая	bumbleride indigo новая
focal	focus	focal sib evo dolby atmos 5 1 2	focus sib evo dolby atmos 5 1 2
vektra	vectra	vektra a	vectra a
ровер	номер	блок управления стеклоподъемниками ленд ровер	блок управления стеклоподъемниками ленд номер
аккамулятор	аккумуляторе	аккамулятор sony на ноутбуки	аккумуляторе sony на ноутбуки
тени	одни	avon палитра тени	avon палитра одни
басаножки	босоножки	басаножки мужские 41 р	босоножки мужские 41 р
акорд	аккорд	акорд 5	аккорд 5
аланский	миланский	аланский дог	миланский дог
планет	планшет	амтел планет r-15	амтел планшет r-15
акомулятор	аккумулятор	iphone 5s акомулятор	iphone 5s аккумулятор
river	rover	pearl river	pearl rover
матиз	машин	боковое зеркало матиз	боковое зеркало машин
алюминивый	алюминиевый	алюминивый обруч	алюминиевый обруч
kit	kia	sony alpha ilca-a77 ii kit 18-135	sony alpha ilca-a77 ii kia 18-135
saiko	seiko	saiko	seiko
soni	sony	soni mhc 44	sony mhc 44
атракционы	аттракцион	атракционы москва	аттракцион москва
ночное	новое	mercedes gl 166 ночное	mercedes gl 166 новое
bend	band	me bend	me band
-новый	новый	автобокс-terra-koffer-atlant-евродеталь-магнум-menabo-новый-yuago-lux-mont-сателлит-терра-active-sotra	автобокс-terra-koffer-atlant-евродеталь-магнум-menabo новый-yuago-lux-mont-сателлит-терра-active-sotra
wolksvagen	volkswagen	wolksvagen газель	volkswagen газель
yoo	yoyo	jenny yoo	jenny yoyo
agent	avent	fear agent	fear avent
классик	пластик	6700 классик	6700 пластик
грабля	грабли	боковая грабля	боковая грабли
бокавые	боковые	бокавые зеркала	боковые зеркала
hts	htc	hts dual sim	htc dual sim
røde	rode	røde podcaster	rode podcaster
camper	cooper	canadian camper karibu	canadian cooper karibu
sts	srs	амортизаторы cadillac sts	амортизаторы cadillac srs
fnb	ати	аккумулятор fnb	аккумулятор ати
cerano	cerato	luisa cerano 44	luisa cerato 44
versa	versace	versa n21	versace n21
аланшет	планшет	аланшет	планшет
densen	denon	densen 410	denon 410
дон	дом	автокузов дон	автокузов дом
облость	области	автокресло ростовская облость	автокресло ростовская области
аммортизатор	амортизатора	аммортизатор хайлендер	амортизатора хайлендер
утюжок	утюгом	ghd утюжок	ghd утюгом
wolksvagen	volkswagen	wolksvagen навигатор	volkswagen навигатор
vanos	lanos	vanos m62	lanos m62
audio	audi	monitor audio gs20	monitor audi gs20
сдм	сжм	белмаш сдм 2500	белмаш сжм 2500
canton	canon	canton 122	canon 122
une	uno	comme une evidence homme	comme uno evidence homme
jig	jog	jig v3 программатор	jog v3 программатор
рамэо	ромео	альфа рамэо	альфа ромео
кришка	крышки	бензо кришка	бензо крышки
аиди	ауди	аиди	ауди
tokina	nokia	tokina 16-28 2 8	nokia 16-28 2 8
салярис	солярис	абсорбер салярис	абсорбер солярис
nanopids	nanopods	elari nanopids	elari nanopods
лед	лет	бмв лед	бмв лет
короб	город	astra короб	astra город
trans	transit	trans sport se	transit sport se
small	smart	small camera	smart camera
grunch	crunch	grunch 224b	crunch 224b
кот	год	белый кот с голубыми глазами	белый год с голубыми глазами
ymaha	yamaha	ymaha музыкальные инструменты	yamaha музыкальные инструменты
gvi	dvi	gvi c3 hd	dvi c3 hd
port	ford	ford split port	ford split ford
laser	lancer	laser лазер	lancer лазер
перед	передня	ауди а6 с5 стойка перед	ауди а6 с5 стойка передня
мкп	мкр	skoda 1 2 мкп	skoda 1 2 мкр
ipone	iphone	ipone 4 s	iphone 4 s
ben	benz	schwalbe big ben mtb	schwalbe big benz mtb
отапления	отопление	батареи отапления	батареи отопление
сенсер	сенсор	samsung a5 сенсер 2017	samsung a5 сенсор 2017
акомулятор	аккумулятор	акомулятор автомобильный	аккумулятор автомобильный
istick	stick	istick	stick
small	smart	small game	smart game
playstatiin	playstation	playstatiin 2	playstation 2
ампер	бампер	12 5 ампер	12 5 бампер
aura	air	kerastase aura	kerastase air
квадрацикл	квадроцикла	резина на квадрацикл 28	резина на квадроцикла 28
mazfa	mazda	mazfa mpv	mazda mpv
finale	final	wahl finale	wahl final
rome	romeo	rome x	romeo x
oled	led	65 oled	65 led
c-класс	класс	mercedes-benz c-класс amg	mercedes-benz класс amg
bob	baby	bob lunar	baby lunar
hyndai	hyundai	hyndai solaris решетка радиатора	hyundai solaris решетка радиатора
cupe	coupe	audi cupe	audi coupe
scoda	skoda	columbus scoda	columbus skoda
experia	xperia	sony experia xz premium	sony xperia xz premium
fjalraven	fjallraven	fjalraven	fjallraven
ehfk	урал	ehfk	урал
ideacenter	ideacentre	lenovo ideacenter	lenovo ideacentre
богажник	багажника	богажник для оки	багажника для оки
zeon	xeon	cooper zeon r14	cooper xeon r14
salvadore	salvatore	salvadore ferragamo туфли	salvatore ferragamo туфли
volswagen	volkswagen	volswagen transporter t4	volkswagen transporter t4
lauder	lauren	estee lauder сыворотка ночная	estee lauren сыворотка ночная
дифузор	диффузор	citroen c3 дифузор	citroen c3 диффузор
beg	bag	beg green egg	bag green egg
ламповый	лампой	trio ламповый	trio лампой
акь	акб	акь	акб
аатомагнитола	автомагнитолы	аатомагнитола пионер	автомагнитолы пионер
бартер	мастер	xiaomi redmi 5 бартер	xiaomi redmi 5 мастер
бетоный	бетонный	бетоный завод рбу	бетонный завод рбу
inter	intel	aurora inter tig pro	aurora intel tig pro
sworks	works	sworks	works
cистема	система	cистема пылеудаления	система пылеудаления
ytha	нерф	ytha	нерф
hunday	hyundai	hunday 3000f	hyundai 3000f
strida	merida	strida фривил	merida фривил
hellis	heelys	hellis	heelys
nexten	nexen	nexten	nexen
canin	canon	royal canin sterilised	royal canon sterilised
wimax	max	yota wimax	yota max
jamaxa	yamaha	jamaxa	yamaha
nicon	nikon	nicon d 3300	nikon d 3300
prx	pro	jbl prx 415m	jbl pro 415m
акумулятор	аккумуляторе	акумулятор электровелосипед	аккумуляторе электровелосипед
excf	exc	excf ktm	exc ktm
sty	stt	moser 1881-0051 easy sty	moser 1881-0051 easy stt
баркас	марка	баркас для выделки шкур	марка для выделки шкур
климота	климат	блок управления климота бмв е39	блок управления климат бмв е39
аккамулятор	аккумуляторы	аккамулятор alcatel onetouch	аккумуляторы alcatel onetouch
aid	air	first aid	first air
грета	света	автомобили новые хендай грета	автомобили новые хендай света
scoda	skoda	brembo scoda	brembo skoda
akai	kia	akai am 69	kia am 69
анап	анапе	анап	анапе
roy	ray	roy norris	ray norris
процесор	процессора	4 ядра процесор xeon x5450	4 ядра процессора xeon x5450
тигровый	торговый	браслет тигровый глаз серебро	браслет торговый глаз серебро
stean	steam	адидас кроссовки stean	адидас кроссовки steam
piavey	peavey	piavey rock master	peavey rock master
сузуки	сумки	бензобак мото сузуки	бензобак мото сумки
nicon	nikon	nicon 610	nikon 610
pantera	pandora	pantera slk брелок	pandora slk брелок
сушки	сумка	база для сушки посуды	база для сумка посуды
duwaly	duwali	duwaly	duwali
shkoda	skoda	shkoda oktavia a7	skoda oktavia a7
мастерка	мастер	forward мастерка	forward мастер
akai	kia	akai advance 25	kia advance 25
lessie	lassie	lessie 98	lassie 98
бозе	базе	бозе мазда 6 gh	базе мазда 6 gh
audio	audi	ps audio lambda	ps audi lambda
famely	family	famely look	family look
аккумуляторный	аккумуляторы	10 8 аккумуляторный бош	10 8 аккумуляторы бош
cart	card	cd cart	cd card
indie	indigo	bumbleride indie 2018	bumbleride indigo 2018
апарат	аппарату	апарат токарно для дерева	аппарату токарно для дерева
акамулятор	аккумулятор	акамулятор на мотороллу	аккумулятор на мотороллу
piple	people	piple	people
коп	кпп	1 и 5 коп 1997-2018	1 и 5 кпп 1997-2018
rein	rain	ideal rein	ideal rain
атракцион	аттракцион	атракцион	аттракцион
bose	bosch	bose t1	bosch t1
versus	ventus	versus-x 300	ventus-x 300
kona	sony	kona entourage	sony entourage
netbook	notebook	ddr3 netbook	ddr3 notebook
jts	gtc	jts-700l	gtc-700l
mihara	mara	mihara 36	mara 36
electra	elantra	harley-davidson electra glide standard	harley-davidson elantra glide standard
russo	rosso	ralph russo	ralph rosso
леди	лет	блузка маленькая леди 146 идеальном	блузка маленькая лет 146 идеальном
abm	bmw	abm rx-200	bmw rx-200
родео	радио	акпп на исузу родео 3 2л	акпп на исузу радио 3 2л
aser	acer	aser e5 511	acer e5 511
dac	mac	usb dac	usb mac
nota	nova	nota bene	nova bene
volksvagen	volkswagen	volksvagen passat b5 универсал	volkswagen passat b5 универсал
tayota	toyota	автодом tayota	автодом toyota
алюминевые	алюминиевый	22 5 алюминевые диски	22 5 алюминиевый диски
плата	платье	lga 1156 материнская плата	lga 1156 материнская платье
аккустические	акустические	аккустические панели	акустические панели
ybr	cbr	ktrnhjvjynf ybr	ktrnhjvjynf cbr
aero	air	gtx 1070 msi aero	gtx 1070 msi air
electra	elantra	electra glide крыло	elantra glide крыло
бпв	бмв	бпв	бмв
aka	akai	lg aka	lg akai
акуммулятор	аккумулятор	акуммулятор на рации	аккумулятор на рации
алина	калина	алина авто авторазбор	калина авто авторазбор
ghjlfdtw	продавец	ghjlfdtw	продавец
именые	именные	браслеты именые	браслеты именные
тайоту	тойота	3 д коврики на тайоту	3 д коврики на тойота
sang	ssang	амортизаторы sang yong	амортизаторы ssang yong
антены	антенну	антены спутник	антенну спутник
wiu	wii	wiu	wii
seed	ceed	kia seed 1 капот	kia ceed 1 капот
g-hock	g-shock	g-hock	g-shock
фолксваген	фольксваген	бампер задний фолксваген гольф 5	бампер задний фольксваген гольф 5
сукко	сумка	сукко	сумка
xiomi	xiaomi	xiomi 5s	xiaomi 5s
венеки	веники	березовые венеки	березовые веники
бенетон	бетон	бенетон	бетон
bose	bosch	bluetooth bose	bluetooth bosch
перед	переезд	бампер перед bmw f16	бампер переезд bmw f16
тверь	дверь	болт тверь	болт дверь
fort	ford	fort nite	ford nite
e-trec	e-trac	e-trec	e-trac
eagl	eagle	eagl	eagle
tdr	ttr	tdr	ttr
лошадка	площадка	barbie и лошадка	barbie и площадка
dauer	bauer	dauer иэ-4716 вэ	bauer иэ-4716 вэ
породы	город	айширской породы	айширской город
pavillion	pavilion	pavillion 5	pavilion 5
gigabite	gigabyte	gigabite poseidon	gigabyte poseidon
запаски	запчасти	camry v55 запаски	camry v55 запчасти
scott	sport	ken scott	ken sport
плата	платье	айфон 5 плата	айфон 5 платье
sin	sim	sin shop	sim shop
geforse	geforce	geforse gtx 960	geforce gtx 960
chic	chicco	l chic	l chicco
ценр	центр	1-к квартира ценр	1-к квартира центр
ful	full	aprilia rs 125 ful power	aprilia rs 125 full power
daiharsu	daihatsu	daiharsu terios	daihatsu terios
aero	air	gigabyte aero 15x	gigabyte air 15x
strida	merida	strida тормоз	merida тормоз
xiami	xiaomi	xiami mi max 2	xiaomi mi max 2
yokahama	yokohama	yokahama geolander	yokohama geolander
kit	kia	fujifilm x-t100 kit	fujifilm x-t100 kia
bmv	bmw	bmv 1	bmw 1
алюминевая	алюминиевая	алюминевая фляга	алюминиевая фляга
комбенизон	комбинезон	reima комбенизон пух	reima комбинезон пух
akai	kia	akai z4	kia z4
wbkbylh	цилиндр	ukfdysq njhvjpyjq wbkbylh	ukfdysq njhvjpyjq цилиндр
beck	back	беговел runbike beck in	беговел runbike back in
hts	htc	hts desire 830 dual sim	htc desire 830 dual sim
aero	air	aero plus	air plus
frendy	fendi	frendy	fendi
pone	ipone	i pone	i ipone
белых	белый	аренда белых такси	аренда белый такси
бра	пара	бра классика	пара классика
зубчининовка	зубчаниновка	самара самарская область зубчининовка	самара самарская область зубчаниновка
aser	acer	aser e1-570g 73538g75mnkk	acer e1-570g 73538g75mnkk
водалей	водолей	автомойка водалей	автомойка водолей
crosser	cruiser	бампер c crosser	бампер c cruiser
калёсо	калесо	7 50 калёсо	7 50 калесо
фольсваген	фольксвагена	акпп фольсваген	акпп фольксвагена
slam	slim	ryobi slam 3000	ryobi slim 3000
запчсти	запчасти	toyota yaris запчсти	toyota yaris запчасти
carat	carlo	fulda carat	fulda carlo
kikx	kick	kikx 1000	kick 1000
можевельник	можжевельника	можевельник 70 см	можжевельника 70 см
аккамулятор	аккумулятора	аккамулятор батарейки	аккумулятора батарейки
белово	белого	белово шкаф	белого шкаф
welgo	wellgo	welgo	wellgo
диспле	дисплея	samsung диспле	samsung дисплея
hdr	hdd	sony hdr as30	sony hdd as30
nex	nexia	sony nex макрокольца	sony nexia макрокольца
yndex	yandex	t9094417231 yndex ru	t9094417231 yandex ru
cbltkrf	сиделка	cbltkrf	сиделка
acura	astra	acura mdx фонарь	astra mdx фонарь
александрова	александров	александрова 9	александров 9
picaso	picasso	picaso x pro	picasso x pro
sante	santa	sante fx v	santa fx v
асоль	ассоль	асоль	ассоль
фольксфаген	фольксваген	авто бу машина фольксфаген поле москва	авто бу машина фольксваген поле москва
клара	карла	gotz клара	gotz карла
outlender	outlander	бампер outlender xl	бампер outlander xl
алюминивая	алюминевая	алюминивая фляга	алюминевая фляга
алеканова	алеканово	алеканова	алеканово
степ	стен	абонемент степ	абонемент стен
tdi	audi	audi 3 0 tdi распредвал	audi 3 0 audi распредвал
кросовки	кроссовки	lacoste кросовки	lacoste кроссовки
cic	ice	bmw cic retrofit adapter	bmw ice retrofit adapter
марафон	смартфон	адидас марафон	адидас смартфон
плата	платье	samsung r780 плата	samsung r780 платье
airpod	airport	airpod правый	airport правый
акорд	аккорды	бампер акорд	бампер аккорды
база	без	база и топ kodi	без и топ kodi
mjx	max	mjx батарея	max батарея
forza	corsa	forza motorsport 4 xbox 360	corsa motorsport 4 xbox 360
фолксваген	фольцваген	акпп фолксваген пассат	акпп фольцваген пассат
rossa	rosso	ferrari 250 testa rossa 1958	ferrari 250 testa rosso 1958
бош	бак	бензопила бош	бензопила бак
антириум	антуриум	антириум	антуриум
шапово	щапово	большое шапово	большое щапово
архипово	архипова	архипово осиповкв	архипова осиповкв
huyndai	hyundai	huyndai elantra	hyundai elantra
yokogama	yokohama	245 45 r19 yokogama	245 45 r19 yokohama
хэндай	хонда	бампер хэндай авторазбор	бампер хонда авторазбор
база	без	база отдыха архипо осиповка	без отдыха архипо осиповка
argent	agent	argent	agent
segs	sega	segs	sega
vil	vip	vil	vip
late	lite	macbook pro 2011 late 13	macbook pro 2011 lite 13
краснадарский	краснодарский	авито ру краснадарский край	авито ру краснодарский край
боллер	бойлер	боллер от котла	бойлер от котла
пбц	бпц	бинокль пбц	бинокль бпц
укладчик	укладки	асфальта укладчик	асфальта укладки
док	дом	thinkpad t440 док	thinkpad t440 дом
матиз	машин	145 70 р13 матиз	145 70 р13 машин
cohen	john	cohen future	john future
antari	antara	antari m1	antara m1
bmv	bmw	bmv	bmw
аксесуары	аксессуары	аксесуары экшен камеры	аксессуары экшен камеры
akai	kia	akai am 2800	kia am 2800
xari	zara	mima xari 3в1	mima zara 3в1
раскат	пассат	авто раскат без залога	авто пассат без залога
bsz	bse	metabo bsz 18	metabo bse 18
банные	ванны	банные	ванны
всборе	сборе	бампер всборе на dodge caliber	бампер сборе на dodge caliber
m-mini	mini	m-mini	mini
focal	focus	focal 16 5 sub	focus 16 5 sub
huawey	huawei	huawey y5 2017	huawei y5 2017
isudzu	isuzu	isudzu исудзу	isuzu исудзу
челси	чулки	ботинки челси 37	ботинки чулки 37
нисан	диван	бампер нисан тино	бампер диван тино
cts	gtx	crown cts	crown gtx
champions	champion	adidas league champions	adidas league champion
папа	пара	vga кабель папа мама	vga кабель пара мама
carol	carlo	carol christian poell	carlo christian poell
-комнатные	комнатные	4-комнатные	4 комнатные
салярис	солярис	боковое зеркало на салярис	боковое зеркало на солярис
zuc	zuk	zuc	zuk
марта	карта	8 марта 21 к 2	8 карта 21 к 2
yari	yaris	rockshox yari	rockshox yaris
phone	iphone	phone 5 se	iphone 5 se
часовой	часов	8 часовой график	8 часов график
перс	пресс	перс рыжая	пресс рыжая
бел	белый	бел шина	белый шина
cruser	cruiser	toyota jl cruser	toyota jl cruiser
cowon	canon	cowon s9	canon s9
cayin	canon	mp3 плеер cayin n3	mp3 плеер canon n3
драгон	дракон	автобусы голден драгон	автобусы голден дракон
denn	denon	denn dek610	denon dek610
акуумулятор	аккумулятор	акуумулятор dualshock 4	аккумулятор dualshock 4
croocs	crocs	croocs	crocs
картридер	картридж	usb 3 картридер	usb 3 картридж
mad	amd	mad professor fuzz	amd professor fuzz
картина	квартира	9 вал картина	9 вал квартира
челны	чехлы	авторазбор камаз 5360набережные челны	авторазбор камаз 5360набережные чехлы
kse	kce	echo kse 2400	echo kce 2400
лес	лет	анапа дом рядом лес	анапа дом рядом лет
susuki	suzuki	susuki intruder 400	suzuki intruder 400
izofix	isofix	автолюлька izofix	автолюлька isofix
макет	монет	банера макет	банера монет
toyo	toyota	toyo at 215 75	toyota at 215 75
канта	карта	натяжной потолок без канта	натяжной потолок без карта
mia	kia	mamma mia	mamma kia
ipone	iphone	ipone 6	iphone 6
велотренажёр	велотренажеры	housefit велотренажёр	housefit велотренажеры
dewolt	dewalt	dewolt уровни	dewalt уровни
хендей	хендай	коврик для багажника хендей солярис	коврик для багажника хендай солярис
avene	avent	avene детский	avent детский
jsb	osb	jsb мини погрузчик	osb мини погрузчик
bulgary	bulgari	bulgary	bulgari
speedy	speed	speedy 30	speed 30
гмр	грм	аренда помещения гмр	аренда помещения грм
epiphone	iphone	epiphone es 339	iphone es 339
катер	камера	silver катер eagle	silver камера eagle
hundai	hyundai	hundai creta торпеда	hyundai creta торпеда
dcd	dvd	dcd 785	dvd 785
cets	getz	cets	getz
couse	cause	just couse 2 xbox 360	just cause 2 xbox 360
fmc	gmc	fila fmc	fila gmc
wes	west	yamaha wes borland	yamaha west borland
опе	опер	бампер опе	бампер опер
ботильены	ботильоны	ботильены 38 39 р	ботильоны 38 39 р
xeox	xeon	speedlink xeox pro analog wireless	speedlink xeon pro analog wireless
поводок	потолок	subaru outback поводок стеклоочистителя b13	subaru outback потолок стеклоочистителя b13
huyndai	hyundai	huyndai solaris руль	hyundai solaris руль
армотизаторы	амортизаторы	армотизаторы 2107	амортизаторы 2107
jelli	jelly	jelli belli	jelly belli
амурская	мужская	амурская область константиновка	мужская область константиновка
cats	cat	kidz n cats	kidz n cat
kit	kia	canon eos 1200d kit 18-55	canon eos 1200d kia 18-55
актюатор	актуатор	актюатор аурис	актуатор аурис
baw	bmw	baw 5 метров	bmw 5 метров
oрел	орел	oрел	орел
movi	move	movi arri	move arri
wfr	vfr	honda wfr	honda vfr
pst	psp	bosch pst 750 pe	bosch psp 750 pe
больная	большая	больная	большая
неоригинал	оригинал	kia sorento 12-бампер передний неоригинал	kia sorento 12-бампер передний оригинал
бабчка	бабочка	бабчка	бабочка
oase	case	oase	case
cart	car	razor crazy cart xl	razor crazy car xl
балдохин	балдахина	балдохин для взрослых	балдахина для взрослых
колпаки	коляски	audi a1 колпаки	audi a1 коляски
socet	socket	intel 1150 socet	intel 1150 socket
scott	sport	scott stego	sport stego
alive	active	dead or alive extreme 3	dead or active extreme 3
атракцион	аттракционы	vr атракцион	vr аттракционы
jtc	gtc	jtc h096b	gtc h096b
выжемной	выжимной	nissan tiida выжемной	nissan tiida выжимной
плата	платья	a320 плата	a320 платья
бра	пара	бра парные	пара парные
vector	vectra	vector vt	vectra vt
подшибник	подшипники	opel astra h опорный подшибник	opel astra h опорный подшипники
стеклоподьемников	стеклоподъемников	альмера классик кнопки стеклоподьемников	альмера классик кнопки стеклоподъемников
падушка	подушки	автомобильная падушка	автомобильная подушки
mackbook	macbook	mackbook	macbook
ark	mark	ark 502	mark 502
разме	размера	бесплатно бутсы разме 42	бесплатно бутсы размера 42
blacview	blackview	blacview	blackview
galaksi	galaxi	galaksi s4	galaxi s4
nexie	nixie	nexie	nixie
фари	фары	ml передние фари 2009 год	ml передние фары 2009 год
akai	kia	akai apc40 mk2	kia apc40 mk2
vjyjrekzh	монокуляр	vjyjrekzh	монокуляр
heep	jeep	uriah heep uk	uriah jeep uk
squier	super	squier precision	super precision
фанарь	фонарь	kia ceed универсал задний фанарь	kia ceed универсал задний фонарь
аксесуары	аксессуары	аксесуары для свадебной фотосессии	аксессуары для свадебной фотосессии
fortin	fortis	fortin evo-chrt6	fortis evo-chrt6
usm	usb	canon 10-22 3 5-4 5 usm	canon 10-22 3 5-4 5 usb
матиз	машин	акб на матиз	акб на машин
dender	fender	dender	fender
kavasaki	kawasaki	kavasaki 250 r	kawasaki 250 r
vrv	мкм	vrv daikin	мкм daikin
prox	pro	prox	pro
басейны	бассейна	басейны надувные	бассейна надувные
bmp	bmw	bmp 104 lcd	bmw 104 lcd
арена	аренда	арена для бейблэйд	аренда для бейблэйд
samsun	samsung	samsun a 3 2017	samsung a 3 2017
baw	bmw	baw манипулятор	bmw манипулятор
городок	город	16 военный городок	16 военный город
maccan	macan	maccan	macan
ikon	iron	ikon tech	iron tech
конвертер	конверт	usb-com25 конвертер	usb-com25 конверт
ironmen	ironman	ironmen пояс	ironman пояс
песочка	песочная	песочка афганка	песочная афганка
дикси	диск	арендатор дикси	арендатор диск
богажник	багажники	opel astra h богажник	opel astra h багажники
wolvo	volvo	wolvo	volvo
toyo	toyota	toyo extensa hp	toyota extensa hp
востания	восстание	1 комнатная квартира в площади востания	1 комнатная квартира в площади восстание
htcgbhfnjh	респиратор	htcgbhfnjh	респиратор
акссесуары	аксессуар	акссесуары xbox 360	аксессуар xbox 360
гросс	кросс	бернский зененхунд гросс	бернский зененхунд кросс
барикады	баррикады	красные барикады астраханская область 40маток и 30ягнят	красные баррикады астраханская область 40маток и 30ягнят
амурская	мужская	1 амурская	1 мужская
аммортизатор	амортизатора	аммортизатор приора	амортизатора приора
oktavia	octavia	skoda oktavia 2006	skoda octavia 2006
xyundai	hyundai	xyundai vitae	hyundai vitae
akai	kia	akai эквалайзер	kia эквалайзер
jimmi	jimny	jimmi choo 39	jimny choo 39
m-класс	класс	mercedes-benz m-класс 2014	mercedes-benz класс 2014
xtrail	x-trail	nissan xtrail гидротрансформатор	nissan x-trail гидротрансформатор
аредна	аренда	аредна авто	аренда авто
citi	city	vento citi	vento city
садовод	садовое	ангарский садовод	ангарский садовое
loren	lauren	us polo ralf loren	us polo ralf lauren
originals	original	кроссовки adidas originals nmd cs	кроссовки adidas original nmd cs
canton	canon	canton ct 920 sc	canon ct 920 sc
rdc	rds	rdc 510	rds 510
renau	renault	renau scenik	renault scenik
бош	бак	бош паркетка бу купить	бак паркетка бу купить
хутор	мотор	белый хутор темрюкский район	белый мотор темрюкский район
ride	red	retro ride	retro red
coop	coup	coop midi	coup midi
hyindai	hyndai	hd78 hyindai	hd78 hyndai
mono	mini	mono 2 1500	mini 2 1500
статор	станок	irbis статор	irbis станок
goose	google	golden goose 41	golden google 41
celvin	celine	celvin klein футболка	celine klein футболка
аккамулятор	аккумулятор	аккамулятор на фредлайнер	аккумулятор на фредлайнер
fantom	phantom	roland fantom xr	roland phantom xr
dac	mac	sonica dac	sonica mac
legenda	legend	legenda героев	legend героев
mathercare	mothercare	mathercare 110 новое	mothercare 110 новое
лечинка	личинка	opel astra h зажигание лечинка	opel astra h зажигание личинка
focal	focus	focal performance ps 165fx	focus performance ps 165fx
берды	бердск	берды	бердск
pear	pearl	jo malone pear	jo malone pearl
mans	man	mans	man
атс	птс	атс станция ссср	птс станция ссср
cornaby	carnaby	cornaby	carnaby
lauder	lauren	sensuous noir estee lauder	sensuous noir estee lauren
башмаг	башмак	башмаг	башмак
ден	один	цифри на ден рожденя	цифри на один рожденя
audio	audi	park audio cf 1800	park audi cf 1800
медальон	медаль	pandora медальон	pandora медаль
dremel	diesel	dremel на запчасти	diesel на запчасти
вины	вина	без вины виноватая	без вина виноватая
саната	сонату	авто запчасти на хундай саната	авто запчасти на хундай сонату
пиновый	новый	6 пиновый провод	6 новый провод
mercedes-	mercedes	mercedes-222	mercedes 222
kicx	kia	kicx ar	kia ar
актавия	октавия	бампер шкода актавия	бампер шкода октавия
тайоту	тойоту	аккумулятор на тайоту	аккумулятор на тойоту
lorac	lorak	lorac	lorak
toskana	toscana	toskana	toscana
arex	aerox	arex	aerox
беле	белое	жилье на беле в аренду	жилье на белое в аренду
tcon	con	tcon-17x	con-17x
feat	fiat	gear feat 2	gear fiat 2
charg	charge	jbl charg 3 оригинал	jbl charge 3 оригинал
калины	машины	бортовой компьютер штат для калины	бортовой компьютер штат для машины
g-system	system	g-system tc	system tc
стрелы	столы	бетонораспределительные стрелы	бетонораспределительные столы
ask	asx	ask bmw e65	asx bmw e65
civik	civic	honda civik eg	honda civic eg
банан	баня	merseders банан	merseders баня
ef-m	ef-s	ef-m	ef-s
buhs	игры	buhs yf gr	игры yf gr
tokina	nokia	tokina at-x pro 28-70mm f2 8	nokia at-x pro 28-70mm f2 8
ermano	ermanno	ermano scervino	ermanno scervino
solo	polo	monster beats solo 3	monster beats polo 3
steve	stels	steve madden сандали	stels madden сандали
метала	металлу	б у метала черепица	б у металлу черепица
плата	платья	iphone 6s плата материнская	iphone 6s платья материнская
обьектива	объектив	canon крышка обьектива	canon крышка объектив
pego	peg	pego	peg
oktavia	octavia	skoda oktavia a7 решотка радиатора	skoda octavia a7 решотка радиатора
cis	cls	doona cis	doona cls
charg	charge	quick charg	quick charge
спальник	купальник	marmot спальник	marmot купальник
btwin	twin	btwin 16	twin 16
carry	carlo	carry me	carlo me
kurtka	artka	kurtka	artka
парта	плита	moll стол парта	moll стол плита
holl	hall	black holl	black hall
багатырева	богатырева	багатырева	богатырева
les	led	les plaisirs nature	led plaisirs nature
база	без	база отдыха продам	без отдыха продам
kio	kia	kio ceed	kia ceed
кубик	купит	5 на 5 кубик	5 на 5 купит
красных	красной	1 комнатная квартира красных партизан	1 комнатная квартира красной партизан
nissin	nissan	nissin teana	nissan teana
аккамуляторы	аккумуляторы	аккамуляторы от ноутбуков	аккумуляторы от ноутбуков
бассеин	бассейна	бассеин детский	бассейна детский
xisiomi	xiaomi	xisiomi	xiaomi
yokogama	yokohama	yokogama ig20 17	yokohama ig20 17
кондицеонера	кондиционер	без кондицеонера	без кондиционер
балкария	болгария	поиск кабардино балкария нальчик	поиск кабардино болгария нальчик
daewo	daewoo	daewo gentra	daewoo gentra
camaro	camry	camaro zl	camry zl
gdf	gsf	gdf 100	gsf 100
решотка	решетки	ауди а6 решотка нижнего бампера	ауди а6 решетки нижнего бампера
